//MAP CONVERTED BY dmm2tgm.py THIS HEADER COMMENT PREVENTS RECONVERSION, DO NOT REMOVE
"aL" = (
/obj/random/trash,
/obj/landmark/no_weather_here,
/turf/simulated/floor/exoplanet/titan_water/minimal,
/area/template_noop)
"aO" = (
/obj/decal/cleanable/generic,
/obj/random/material,
/obj/random/material,
/obj/random/material,
/obj/random/material,
/obj/landmark/no_weather_here,
/turf/simulated/floor/exoplanet/titan_water/minimal,
/area/template_noop)
"aY" = (
/obj/structure/catwalk,
/turf/simulated/floor/exoplanet/titan_water/minimal,
/area/template_noop)
"by" = (
/obj/item/stack/material/rods,
/obj/landmark/no_weather_here,
/turf/simulated/floor/exoplanet/titan_water/minimal,
/area/template_noop)
"cy" = (
/obj/landmark/no_weather_here,
/obj/decal/skat_decals/water_and_pipes,
/turf/simulated/floor/exoplanet/titan_water/minimal,
/area/template_noop)
"cH" = (
/obj/random/trash,
/turf/simulated/floor/exoplanet/titan_water/minimal,
/area/template_noop)
"em" = (
/obj/random/material,
/obj/random/material,
/obj/random/material,
/obj/landmark/no_weather_here,
/turf/simulated/floor/exoplanet/titan_water/minimal,
/area/template_noop)
"eQ" = (
/obj/structure/grille/broken,
/obj/random/biggun,
/obj/random/biggun,
/obj/random/biggun,
/obj/landmark/no_weather_here,
/turf/simulated/floor/exoplanet/titan_water/minimal,
/area/template_noop)
"gq" = (
/obj/item/stack/material/rods,
/turf/simulated/floor/exoplanet/titan_water/minimal,
/area/template_noop)
"iO" = (
/obj/decal/cleanable/generic,
/turf/simulated/floor/exoplanet/titan_water/minimal,
/area/template_noop)
"jO" = (
/obj/random/material,
/obj/random/material,
/obj/random/material,
/obj/random/material,
/obj/landmark/no_weather_here,
/turf/simulated/floor/exoplanet/titan_water/minimal,
/area/template_noop)
"lP" = (
/obj/decal/cleanable/generic,
/obj/landmark/no_weather_here,
/turf/simulated/floor/exoplanet/titan_water/minimal,
/area/template_noop)
"lW" = (
/obj/structure/catwalk,
/obj/landmark/no_weather_here,
/turf/simulated/floor/exoplanet/titan_water/minimal,
/area/template_noop)
"mb" = (
/obj/structure/door_assembly,
/obj/landmark/no_weather_here,
/turf/simulated/floor/exoplanet/titan_water/minimal,
/area/template_noop)
"rR" = (
/obj/decal/cleanable/generic,
/obj/random/material,
/turf/simulated/floor/exoplanet/titan_water/minimal,
/area/template_noop)
"sk" = (
/obj/landmark/no_weather_here,
/obj/decal/skat_decals/wires_first,
/turf/simulated/floor/exoplanet/titan_water/minimal,
/area/template_noop)
"tQ" = (
/obj/landmark/no_weather_here,
/turf/simulated/wall/concrete,
/area/template_noop)
"uf" = (
/obj/random/trash,
/obj/decal/cleanable/generic,
/obj/landmark/no_weather_here,
/turf/simulated/floor/exoplanet/titan_water/minimal,
/area/template_noop)
"vf" = (
/turf/template_noop,
/area/template_noop)
"vK" = (
/obj/structure/grille/broken,
/obj/random/biggun,
/obj/landmark/no_weather_here,
/turf/simulated/floor/exoplanet/titan_water/minimal,
/area/template_noop)
"wJ" = (
/obj/random/material,
/obj/random/material,
/obj/landmark/no_weather_here,
/turf/simulated/floor/exoplanet/titan_water/minimal,
/area/template_noop)
"xf" = (
/obj/decal/cleanable/generic,
/obj/random/material,
/obj/landmark/no_weather_here,
/turf/simulated/floor/exoplanet/titan_water/minimal,
/area/template_noop)
"xs" = (
/obj/landmark/no_weather_here,
/obj/decal/skat_decals/wall_left_wires,
/turf/simulated/floor/exoplanet/titan_water/minimal,
/area/template_noop)
"zI" = (
/obj/structure/grille/broken,
/obj/structure/grille/broken,
/obj/random/biggun,
/obj/landmark/no_weather_here,
/turf/simulated/floor/exoplanet/titan_water/minimal,
/area/template_noop)
"AA" = (
/obj/structure/grille/broken,
/obj/item/stack/material/rods,
/turf/simulated/floor/exoplanet/titan_water/minimal,
/area/template_noop)
"Bd" = (
/obj/structure/grille/broken,
/obj/random/biggun,
/obj/landmark/no_weather_here,
/obj/decal/skat_decals/wall_right_leaking_pipe,
/turf/simulated/floor/exoplanet/titan_water/minimal,
/area/template_noop)
"CS" = (
/obj/random/material,
/turf/simulated/floor/exoplanet/titan_water/minimal,
/area/template_noop)
"Ds" = (
/obj/structure/barrier/avanpost,
/turf/simulated/floor/exoplanet/titan_water/minimal,
/area/template_noop)
"DH" = (
/obj/random/material,
/obj/landmark/no_weather_here,
/turf/simulated/floor/exoplanet/titan_water/minimal,
/area/template_noop)
"Fj" = (
/turf/simulated/floor/exoplanet/titan_water/minimal,
/area/template_noop)
"Hu" = (
/obj/landmark/no_weather_here,
/obj/decal/skat_decals/wall_right_leaking_pipe,
/turf/simulated/floor/exoplanet/titan_water/minimal,
/area/template_noop)
"HY" = (
/obj/decal/cleanable/generic,
/obj/random/material,
/obj/random/material,
/obj/random/material,
/obj/landmark/no_weather_here,
/turf/simulated/floor/exoplanet/titan_water/minimal,
/area/template_noop)
"IH" = (
/obj/structure/grille/broken,
/obj/item/stack/material/rods,
/obj/landmark/no_weather_here,
/turf/simulated/floor/exoplanet/titan_water/minimal,
/area/template_noop)
"Jd" = (
/obj/structure/catwalk,
/obj/item/stack/material/rods,
/obj/landmark/no_weather_here,
/turf/simulated/floor/exoplanet/titan_water/minimal,
/area/template_noop)
"Mq" = (
/obj/random/loot,
/obj/landmark/no_weather_here,
/turf/simulated/floor/exoplanet/titan_water/minimal,
/area/template_noop)
"Mu" = (
/obj/structure/grille/broken,
/turf/simulated/floor/exoplanet/titan_water/minimal,
/area/template_noop)
"Mw" = (
/obj/structure/door_assembly,
/obj/landmark/no_weather_here,
/obj/decal/skat_decals/wires_first,
/turf/simulated/floor/exoplanet/titan_water/minimal,
/area/template_noop)
"Px" = (
/obj/landmark/no_weather_here,
/turf/simulated/floor/exoplanet/titan_water/minimal,
/area/template_noop)
"Qb" = (
/obj/random/loot,
/turf/simulated/floor/exoplanet/titan_water/minimal,
/area/template_noop)

(1,1,1) = {"
vf
vf
Fj
Fj
Fj
vf
vf
Fj
Fj
Fj
Fj
Fj
vf
Fj
Fj
vf
Fj
Fj
Fj
Fj
Fj
Fj
Fj
Fj
Fj
vf
vf
vf
vf
vf
"}
(2,1,1) = {"
vf
Fj
Fj
Fj
Fj
Fj
Fj
Fj
Fj
Fj
Fj
Fj
Fj
Fj
Fj
Fj
Fj
Fj
Fj
Fj
Fj
Fj
Fj
Fj
Fj
Fj
vf
vf
vf
vf
"}
(3,1,1) = {"
vf
vf
Fj
Fj
Fj
Fj
iO
Fj
Fj
Fj
tQ
Hu
Fj
Fj
Fj
Fj
Fj
Fj
Fj
Fj
Fj
Fj
Fj
Fj
Fj
Fj
Fj
vf
vf
vf
"}
(4,1,1) = {"
vf
vf
Fj
Fj
Fj
Fj
Fj
Fj
Fj
Fj
tQ
Px
Fj
lP
Px
uf
Px
Fj
cH
Fj
Fj
cH
Fj
Fj
Fj
Fj
Fj
vf
vf
vf
"}
(5,1,1) = {"
vf
vf
vf
Fj
Fj
Fj
Fj
Fj
Fj
Fj
tQ
Px
lP
Px
Px
Px
Px
Px
iO
Fj
Fj
Fj
tQ
Fj
Fj
Fj
vf
vf
vf
vf
"}
(6,1,1) = {"
vf
Fj
Fj
Fj
Fj
Fj
Fj
Fj
Fj
Fj
tQ
tQ
Px
Px
tQ
tQ
tQ
Px
Px
cH
Fj
Px
tQ
Fj
Fj
Fj
vf
vf
vf
vf
"}
(7,1,1) = {"
vf
Fj
Fj
Fj
iO
Fj
Fj
Fj
Fj
Fj
tQ
cy
Mq
Px
tQ
Px
Px
Px
Px
Mq
Px
Px
tQ
Fj
Fj
Fj
vf
vf
vf
vf
"}
(8,1,1) = {"
vf
Fj
Fj
Fj
Fj
iO
Fj
Fj
Fj
Fj
tQ
Px
Px
Px
tQ
Px
Px
Px
aL
Px
lP
Px
tQ
Fj
Fj
Fj
vf
vf
vf
vf
"}
(9,1,1) = {"
vf
Fj
Fj
Fj
Fj
Fj
Fj
Fj
Fj
Fj
tQ
Px
Px
Px
tQ
tQ
tQ
tQ
Px
Px
Px
tQ
tQ
Fj
Fj
vf
vf
vf
vf
vf
"}
(10,1,1) = {"
vf
vf
Fj
Fj
Fj
Fj
Fj
iO
Fj
Fj
tQ
Px
lP
Px
Px
Px
Px
Px
Px
Px
Px
aL
tQ
Fj
Fj
vf
vf
vf
vf
vf
"}
(11,1,1) = {"
vf
vf
vf
Fj
Fj
Fj
Fj
Fj
Fj
Fj
tQ
Px
Px
Px
Px
Px
lP
Px
Px
aL
Px
Px
tQ
Fj
Fj
vf
vf
vf
vf
vf
"}
(12,1,1) = {"
vf
vf
vf
Fj
Fj
Fj
Fj
Fj
Fj
Fj
tQ
Px
Px
Px
Mq
Px
Px
aL
Px
Px
Px
Px
tQ
Fj
Fj
vf
vf
vf
vf
vf
"}
(13,1,1) = {"
vf
vf
Fj
Fj
Fj
Fj
Fj
Fj
iO
Fj
tQ
Px
Px
Px
Px
Px
Px
Px
Px
Px
Px
aL
tQ
Fj
Fj
Fj
vf
vf
vf
vf
"}
(14,1,1) = {"
vf
Fj
Fj
Fj
Fj
Fj
Fj
Fj
Fj
Fj
tQ
tQ
tQ
tQ
tQ
tQ
tQ
tQ
tQ
tQ
Mw
tQ
tQ
Fj
Fj
Fj
vf
vf
vf
vf
"}
(15,1,1) = {"
vf
Fj
Fj
Fj
Fj
Fj
Fj
cH
Fj
Fj
Fj
Fj
Fj
Fj
Fj
Fj
Fj
Fj
Fj
Fj
Fj
Fj
Fj
Ds
Fj
vf
vf
vf
vf
vf
"}
(16,1,1) = {"
vf
Fj
Fj
Fj
Fj
Fj
Fj
Fj
Fj
Fj
Fj
aY
Fj
cH
Fj
Fj
Fj
gq
Fj
iO
Fj
Fj
Fj
Ds
Fj
vf
vf
vf
vf
vf
"}
(17,1,1) = {"
vf
vf
vf
Fj
iO
Fj
Fj
Fj
Fj
Fj
aY
Fj
Fj
aY
Fj
aY
Fj
cH
Fj
Fj
Qb
Fj
Fj
Fj
Fj
vf
vf
vf
vf
vf
"}
(18,1,1) = {"
vf
vf
vf
Fj
Fj
Fj
Fj
Fj
cH
Fj
Fj
Fj
aY
Fj
Fj
Fj
Fj
Fj
Fj
Fj
Fj
Fj
Fj
Ds
vf
vf
vf
vf
vf
vf
"}
(19,1,1) = {"
vf
vf
vf
Fj
Fj
Fj
Fj
Fj
CS
iO
Fj
gq
Fj
Fj
Fj
iO
iO
Fj
Fj
Fj
Fj
Fj
Fj
Ds
vf
vf
vf
vf
vf
vf
"}
(20,1,1) = {"
vf
vf
Fj
Fj
Fj
Fj
rR
Fj
Fj
Fj
Fj
Mu
Mu
AA
tQ
tQ
tQ
tQ
tQ
tQ
tQ
tQ
tQ
Fj
Fj
vf
vf
vf
vf
vf
"}
(21,1,1) = {"
vf
Fj
Fj
Fj
Fj
Fj
Fj
CS
CS
Fj
Fj
gq
Fj
Fj
tQ
sk
Px
Px
Px
Px
xs
Px
tQ
Fj
Fj
vf
vf
vf
vf
vf
"}
(22,1,1) = {"
vf
Fj
Fj
iO
Fj
tQ
tQ
mb
tQ
tQ
Fj
Fj
iO
Fj
tQ
eQ
Jd
Px
Px
tQ
Px
lP
tQ
Fj
Fj
Fj
vf
vf
vf
vf
"}
(23,1,1) = {"
vf
vf
Fj
iO
Fj
tQ
jO
Px
aO
tQ
Fj
Fj
Fj
Fj
tQ
vK
Px
IH
tQ
tQ
Px
Px
tQ
Fj
Fj
Fj
vf
vf
vf
vf
"}
(24,1,1) = {"
vf
vf
Fj
Fj
Fj
tQ
em
DH
em
tQ
iO
Fj
cH
Fj
tQ
Bd
Px
Px
tQ
cy
by
Px
tQ
Fj
Fj
Fj
vf
vf
vf
vf
"}
(25,1,1) = {"
vf
vf
Fj
Fj
Fj
tQ
wJ
xf
jO
tQ
Fj
Fj
Fj
Fj
tQ
vK
Px
tQ
tQ
Px
Jd
Px
tQ
Fj
Fj
Fj
vf
vf
vf
vf
"}
(26,1,1) = {"
vf
vf
Fj
Fj
Fj
tQ
em
Px
wJ
tQ
Fj
Fj
Fj
Fj
tQ
zI
Px
Px
tQ
Px
Px
Px
tQ
Fj
Fj
Fj
Fj
vf
vf
vf
"}
(27,1,1) = {"
vf
vf
Fj
Fj
Fj
tQ
wJ
Px
HY
tQ
Fj
Fj
Fj
iO
tQ
Px
Px
lP
Px
lW
Px
lP
tQ
Fj
Fj
Fj
Fj
vf
vf
vf
"}
(28,1,1) = {"
vf
vf
Fj
Fj
Fj
tQ
tQ
tQ
tQ
tQ
Fj
Fj
Fj
Fj
tQ
tQ
tQ
tQ
Mw
tQ
tQ
tQ
tQ
Fj
Fj
Fj
vf
vf
vf
vf
"}
(29,1,1) = {"
vf
vf
Fj
Fj
iO
Fj
Fj
Fj
Fj
Fj
Fj
Fj
iO
Fj
Fj
Fj
Fj
Fj
Fj
Fj
Fj
Fj
Fj
Fj
Fj
vf
vf
vf
vf
vf
"}
(30,1,1) = {"
vf
vf
Fj
Fj
Fj
Fj
Fj
Fj
Fj
Fj
Fj
Fj
iO
Fj
Fj
Fj
Fj
Fj
cH
Fj
iO
Fj
Fj
Fj
vf
vf
vf
vf
vf
vf
"}
