//MAP CONVERTED BY dmm2tgm.py THIS HEADER COMMENT PREVENTS RECONVERSION, DO NOT REMOVE
"aF" = (
/obj/structure/closet/firecloset,
/obj/structure/aurora/wall_light{
	dir = 4
	},
/obj/decal/cleanable/dirt,
/turf/simulated/floor/holofloor/tiled,
/area/map_template/anomaly/bunker)
"br" = (
/obj/structure/table/steel_reinforced,
/obj/structure/aurora/wall_light{
	dir = 1
	},
/obj/random/contraband,
/obj/decal/cleanable/dirt,
/turf/simulated/floor/holofloor/tiled,
/area/map_template/anomaly/bunker)
"bI" = (
/obj/structure/aurora/wall_light{
	dir = 1
	},
/obj/decal/cleanable/dirt,
/obj/machinery/fabricator/rnd/protolathe,
/obj/item/storage/box/autolathe_designs,
/turf/simulated/floor/holofloor/tiled,
/area/map_template/anomaly/bunker)
"bX" = (
/obj/machinery/computer/rdconsole/core/colony{
	req_access = list();
	dir = 1
	},
/obj/decal/cleanable/dirt,
/turf/simulated/floor/holofloor/tiled,
/area/map_template/anomaly/bunker)
"cb" = (
/obj/structure/hygiene/toilet{
	dir = 8
	},
/obj/decal/cleanable/dirt,
/turf/simulated/floor/holofloor/tiled,
/area/map_template/anomaly/bunker)
"cg" = (
/turf/simulated/wall/titanium,
/area/map_template/anomaly/bunker)
"dj" = (
/obj/structure/rubble/house,
/obj/random/trash,
/obj/item/stack/material/rods,
/turf/simulated/floor/holofloor/tiled,
/area/template_noop)
"eb" = (
/obj/structure/hygiene/sink{
	pixel_y = -12
	},
/obj/decal/cleanable/dirt,
/turf/simulated/floor/holofloor/tiled,
/area/map_template/anomaly/bunker)
"eL" = (
/obj/structure/closet/emcloset,
/obj/decal/cleanable/dirt,
/turf/simulated/floor/holofloor/tiled,
/area/map_template/anomaly/bunker)
"fn" = (
/obj/machinery/vending/tool,
/turf/simulated/floor/holofloor/tiled,
/area/map_template/anomaly/bunker)
"fr" = (
/obj/random/trash,
/turf/simulated/floor/exoplanet/snow,
/area/template_noop)
"fH" = (
/turf/simulated/wall/titanium,
/area/template_noop)
"gP" = (
/obj/structure/aurora/wall_light{
	dir = 1
	},
/obj/decal/cleanable/generic,
/obj/decal/cleanable/dirt,
/turf/simulated/floor/holofloor/tiled,
/area/map_template/anomaly/bunker)
"hn" = (
/obj/structure/aurora/wall_light{
	dir = 1
	},
/turf/simulated/floor/exoplanet/snow,
/area/template_noop)
"hq" = (
/obj/decal/cleanable/generic,
/turf/simulated/floor/exoplanet/snow,
/area/template_noop)
"ib" = (
/obj/machinery/washing_machine,
/obj/decal/cleanable/dirt,
/turf/simulated/floor/holofloor/tiled,
/area/map_template/anomaly/bunker)
"kt" = (
/obj/anomaly/electra/three_and_three/tesla_second,
/turf/simulated/floor/exoplanet/snow,
/area/template_noop)
"kM" = (
/obj/structure/closet/radiation,
/obj/decal/cleanable/dirt,
/turf/simulated/floor/holofloor/tiled,
/area/map_template/anomaly/bunker)
"lJ" = (
/obj/structure/bed/chair/comfy/brown,
/obj/decal/cleanable/generic,
/obj/decal/cleanable/dirt,
/turf/simulated/floor/holofloor/tiled,
/area/map_template/anomaly/bunker)
"lN" = (
/obj/machinery/constructable_frame,
/turf/simulated/floor/holofloor/tiled,
/area/template_noop)
"lO" = (
/obj/structure/rubble/house,
/obj/random/trash,
/obj/structure/largecrate,
/obj/random/loot,
/obj/random/loot,
/obj/random/loot,
/obj/random/loot,
/obj/random/loot,
/turf/simulated/floor/holofloor/tiled,
/area/template_noop)
"lS" = (
/obj/machinery/portable_atmospherics/canister/oxygen,
/obj/structure/railing/mapped{
	dir = 1;
	icon_state = "railing0-1"
	},
/turf/simulated/floor/holofloor/tiled,
/area/map_template/anomaly/bunker)
"mb" = (
/obj/random/trash,
/turf/simulated/floor/holofloor/tiled,
/area/template_noop)
"op" = (
/obj/structure/aurora/wall_light{
	dir = 8
	},
/obj/machinery/vending/engineering{
	req_access = list()
	},
/turf/simulated/floor/holofloor/tiled,
/area/map_template/anomaly/bunker)
"oS" = (
/obj/structure/aurora/wall_light,
/obj/decal/cleanable/dirt,
/turf/simulated/floor/holofloor/tiled,
/area/map_template/anomaly/bunker)
"oX" = (
/obj/structure/table/steel_reinforced,
/obj/decal/cleanable/dirt,
/obj/random/firstaid,
/turf/simulated/floor/holofloor/tiled,
/area/map_template/anomaly/bunker)
"pl" = (
/obj/structure/reagent_dispensers/watertank,
/obj/decal/cleanable/dirt,
/turf/simulated/floor/holofloor/tiled,
/area/map_template/anomaly/bunker)
"qc" = (
/obj/structure/rubble/house,
/obj/item/stack/material/rods,
/obj/decal/cleanable/dirt,
/obj/landmark/no_weather_here,
/turf/simulated/floor/holofloor/tiled,
/area/template_noop)
"qL" = (
/obj/decal/cleanable/dirt,
/obj/structure/table/rack,
/obj/item/storage/firstaid/combat/bunker,
/obj/item/storage/firstaid/combat/bunker,
/obj/item/storage/firstaid/combat/bunker,
/turf/simulated/floor/holofloor/tiled,
/area/map_template/anomaly/bunker)
"qM" = (
/obj/machinery/anomaly_container{
	req_access = list()
	},
/obj/decal/cleanable/dirt,
/turf/simulated/floor/holofloor/tiled,
/area/map_template/anomaly/bunker)
"ro" = (
/obj/structure/rubble/house,
/obj/decal/cleanable/dirt,
/turf/simulated/floor/holofloor/tiled,
/area/map_template/anomaly/bunker)
"tT" = (
/obj/machinery/r_n_d/destructive_analyzer,
/obj/structure/extinguisher_cabinet{
	pixel_x = -7;
	pixel_y = 32
	},
/obj/decal/cleanable/dirt,
/turf/simulated/floor/holofloor/tiled,
/area/map_template/anomaly/bunker)
"ua" = (
/obj/structure/grille/broken,
/obj/anomaly/electra/three_and_three/tesla_second,
/turf/simulated/floor/exoplanet/snow,
/area/template_noop)
"uE" = (
/obj/structure/aurora/beaker_dropper,
/obj/structure/aurora/wall_light{
	dir = 1
	},
/obj/decal/cleanable/dirt,
/turf/simulated/floor/holofloor/tiled,
/area/map_template/anomaly/bunker)
"uX" = (
/obj/structure/rubble/house,
/obj/random/trash,
/obj/decal/cleanable/dirt,
/turf/simulated/floor/holofloor/tiled,
/area/template_noop)
"vg" = (
/obj/structure/rubble/house,
/obj/structure/aurora/wall_light{
	dir = 1
	},
/obj/decal/cleanable/dirt,
/turf/simulated/floor/holofloor/tiled,
/area/map_template/anomaly/bunker)
"vi" = (
/obj/decal/cleanable/generic,
/obj/decal/cleanable/dirt,
/obj/item/disk/secret_project/science,
/turf/simulated/floor/holofloor/tiled,
/area/map_template/anomaly/bunker)
"vR" = (
/obj/structure/table/steel_reinforced,
/obj/decal/cleanable/dirt,
/turf/simulated/floor/holofloor/tiled,
/area/map_template/anomaly/bunker)
"vW" = (
/obj/decal/cleanable/dirt,
/obj/structure/table/steel_reinforced,
/obj/item/paper/Court{
	info = "Техника отказала, пишу на эту бумажку. Наш отряд вернулся с полевой экспедиции и обнаружила, что основная научная группа эвакуировалась.  Если кто-то из наших вернётся, мы отправились на местную гору, высота номер 102, попытаемся свзяаться с штабом. Техника сгорела из-за откуда-то взявшейся молнии, чертовщина...";
	name = "Записка"
	},
/obj/item/disk/secret_project/science,
/obj/item/disk/secret_project/science,
/obj/item/disk/secret_project/science,
/obj/item/disk/secret_project/science,
/turf/simulated/floor/holofloor/tiled,
/area/map_template/anomaly/bunker)
"wa" = (
/obj/structure/largecrate,
/obj/random/loot,
/obj/random/loot,
/obj/random/loot,
/obj/random/loot,
/obj/random/loot,
/turf/simulated/floor/holofloor/tiled,
/area/template_noop)
"wv" = (
/obj/structure/table/steel_reinforced,
/obj/machinery/door/window{
	autoset_access = 0;
	dir = 1;
	pixel_y = -26
	},
/obj/machinery/door/window{
	autoset_access = 0;
	dir = 1
	},
/turf/simulated/floor/holofloor/tiled,
/area/map_template/anomaly/bunker)
"wM" = (
/obj/structure/rubble/house,
/obj/random/trash,
/turf/simulated/floor/holofloor/tiled,
/area/template_noop)
"wQ" = (
/turf/template_noop,
/area/template_noop)
"xu" = (
/obj/structure/girder/displaced,
/turf/simulated/floor/exoplanet/snow,
/area/template_noop)
"xG" = (
/obj/machinery/vending/engivend{
	req_access = list()
	},
/turf/simulated/floor/holofloor/tiled,
/area/map_template/anomaly/bunker)
"xJ" = (
/obj/structure/rubble/house,
/obj/decal/cleanable/dirt,
/obj/landmark/no_weather_here,
/turf/simulated/floor/holofloor/tiled,
/area/template_noop)
"yx" = (
/turf/simulated/floor/exoplanet/snow,
/area/map_template/anomaly/bunker)
"zk" = (
/obj/wallframe_spawn/reinforced/titanium,
/turf/template_noop,
/area/map_template/anomaly/bunker)
"zx" = (
/obj/decal/cleanable/dirt,
/obj/structure/table/rack,
/obj/item/storage/firstaid/combat/special/bunker,
/obj/item/storage/firstaid/combat/special/bunker,
/obj/item/storage/firstaid/combat/special/bunker,
/turf/simulated/floor/holofloor/tiled,
/area/map_template/anomaly/bunker)
"zW" = (
/obj/structure/curtain/open/shower,
/obj/decal/cleanable/dirt,
/turf/simulated/floor/holofloor/tiled,
/area/map_template/anomaly/bunker)
"AB" = (
/obj/decal/cleanable/dirt,
/turf/simulated/floor/holofloor/tiled,
/area/map_template/anomaly/bunker)
"By" = (
/obj/item/stack/material/rods,
/turf/simulated/floor/exoplanet/snow,
/area/template_noop)
"BS" = (
/obj/structure/aurora/smes,
/turf/simulated/floor/holofloor/tiled,
/area/map_template/anomaly/bunker)
"CI" = (
/obj/structure/aurora/wall_light{
	dir = 1
	},
/turf/simulated/floor/tiled/techmaint,
/area/map_template/anomaly/bunker)
"Dr" = (
/obj/structure/rubble/house,
/obj/decal/cleanable/generic,
/turf/simulated/floor/holofloor/tiled,
/area/template_noop)
"Ek" = (
/obj/structure/aurora/vault_door,
/turf/simulated/floor/holofloor/tiled,
/area/map_template/anomaly/bunker)
"Fi" = (
/obj/structure/largecrate,
/obj/random/loot,
/obj/random/loot,
/obj/random/loot,
/obj/random/loot,
/obj/random/loot,
/turf/simulated/floor/exoplanet/snow,
/area/template_noop)
"FP" = (
/obj/structure/table/rack,
/obj/item/clothing/suit/space/void/atmos,
/obj/item/clothing/head/helmet/space/void/atmos,
/obj/item/tank/oxygen,
/obj/structure/railing/mapped{
	dir = 1;
	icon_state = "railing0-1"
	},
/turf/simulated/floor/holofloor/tiled,
/area/map_template/anomaly/bunker)
"Gy" = (
/obj/structure/rubble/house,
/obj/random/trash,
/obj/item/stack/material/rods,
/obj/decal/cleanable/dirt,
/turf/simulated/floor/holofloor/tiled,
/area/template_noop)
"GF" = (
/obj/structure/aurora/wall_light{
	dir = 8
	},
/obj/decal/cleanable/dirt,
/obj/structure/table/steel_reinforced,
/obj/item/disk/secret_project/science,
/obj/item/disk/secret_project/science,
/obj/item/disk/secret_project/science,
/obj/item/toy/bronze_pig,
/turf/simulated/floor/holofloor/tiled,
/area/map_template/anomaly/bunker)
"Hk" = (
/obj/structure/rubble/house,
/obj/decal/cleanable/generic,
/obj/decal/cleanable/dirt,
/obj/landmark/no_weather_here,
/turf/simulated/floor/holofloor/tiled,
/area/template_noop)
"HI" = (
/obj/structure/hygiene/shower{
	dir = 4
	},
/obj/decal/cleanable/dirt,
/turf/simulated/floor/holofloor/tiled,
/area/map_template/anomaly/bunker)
"Ih" = (
/obj/structure/dispenser/oxygen,
/obj/decal/cleanable/dirt,
/turf/simulated/floor/holofloor/tiled,
/area/map_template/anomaly/bunker)
"IH" = (
/obj/random/masks,
/turf/simulated/floor/exoplanet/snow,
/area/template_noop)
"IS" = (
/obj/machinery/door/airlock,
/turf/simulated/floor/holofloor/tiled,
/area/map_template/anomaly/bunker)
"KT" = (
/obj/structure/table/steel_reinforced,
/obj/random/toolbox,
/obj/decal/cleanable/dirt,
/turf/simulated/floor/holofloor/tiled,
/area/map_template/anomaly/bunker)
"Lx" = (
/obj/decal/cleanable/generic,
/obj/decal/cleanable/dirt,
/turf/simulated/floor/holofloor/tiled,
/area/map_template/anomaly/bunker)
"OQ" = (
/obj/structure/table/steel_reinforced,
/obj/decal/cleanable/dirt,
/obj/random/contraband,
/turf/simulated/floor/holofloor/tiled,
/area/map_template/anomaly/bunker)
"Pi" = (
/obj/machinery/door/blast/regular/open,
/obj/structure/broken_door,
/turf/simulated/floor/exoplanet/snow,
/area/template_noop)
"Pk" = (
/obj/structure/aurora/old_comp,
/obj/structure/table/steel_reinforced,
/obj/decal/cleanable/dirt,
/turf/simulated/floor/holofloor/tiled,
/area/map_template/anomaly/bunker)
"Pl" = (
/obj/structure/aurora/wall_light{
	dir = 1
	},
/obj/decal/cleanable/dirt,
/turf/simulated/floor/holofloor/tiled,
/area/map_template/anomaly/bunker)
"Sq" = (
/obj/machinery/door/airlock,
/obj/decal/cleanable/dirt,
/turf/simulated/floor/holofloor/tiled,
/area/map_template/anomaly/bunker)
"Tb" = (
/obj/decal/cleanable/dirt,
/obj/machinery/fabricator/rnd/imprinter,
/turf/simulated/floor/holofloor/tiled,
/area/map_template/anomaly/bunker)
"Td" = (
/obj/structure/aurora/wall_light,
/turf/simulated/floor/exoplanet/snow,
/area/template_noop)
"TO" = (
/obj/machinery/door/blast/regular/open,
/obj/structure/broken_door,
/turf/simulated/floor/tiled/techmaint,
/area/map_template/anomaly/bunker)
"Vd" = (
/obj/structure/rubble/house,
/turf/simulated/floor/holofloor/tiled,
/area/template_noop)
"Vi" = (
/obj/structure/table/steel_reinforced,
/obj/structure/aurora/wall_light{
	dir = 4
	},
/obj/decal/cleanable/dirt,
/turf/simulated/floor/holofloor/tiled,
/area/map_template/anomaly/bunker)
"WC" = (
/obj/machinery/stasis_cage{
	req_access = list()
	},
/turf/simulated/floor/holofloor/tiled,
/area/template_noop)
"WQ" = (
/turf/simulated/wall/titanium/bunker_map,
/area/map_template/anomaly/bunker)
"XD" = (
/obj/structure/grille/broken,
/turf/simulated/floor/exoplanet/snow,
/area/template_noop)
"Yr" = (
/obj/structure/table/steel_reinforced,
/obj/item/device/integrated_circuit_printer/upgraded{
	pixel_y = 2
	},
/obj/item/storage/toolbox/mechanical{
	pixel_y = -12
	},
/obj/item/clothing/glasses/science,
/obj/decal/cleanable/dirt,
/turf/simulated/floor/holofloor/tiled,
/area/map_template/anomaly/bunker)
"Yv" = (
/turf/simulated/floor/holofloor/tiled,
/area/map_template/anomaly/bunker)
"YF" = (
/obj/structure/table/steel_reinforced,
/obj/decal/cleanable/dirt,
/obj/item/integrated_circuit/arithmetic/random,
/turf/simulated/floor/holofloor/tiled,
/area/map_template/anomaly/bunker)
"YK" = (
/obj/structure/grille/broken,
/obj/item/stack/material/rods,
/turf/simulated/floor/exoplanet/snow,
/area/template_noop)
"YZ" = (
/obj/decal/cleanable/dirt,
/obj/item/disk/secret_project/science,
/turf/simulated/floor/holofloor/tiled,
/area/map_template/anomaly/bunker)
"Zu" = (
/obj/wallframe_spawn/reinforced/titanium,
/turf/simulated/wall/titanium,
/area/map_template/anomaly/bunker)
"ZL" = (
/turf/simulated/floor/exoplanet/snow,
/area/template_noop)

(1,1,1) = {"
wQ
wQ
wQ
wQ
wQ
wQ
wQ
wQ
wQ
wQ
wQ
wQ
wQ
wQ
wQ
wQ
wQ
wQ
wQ
wQ
wQ
wQ
wQ
wQ
wQ
wQ
wQ
wQ
wQ
wQ
wQ
wQ
wQ
wQ
wQ
wQ
wQ
wQ
wQ
wQ
wQ
"}
(2,1,1) = {"
wQ
wQ
wQ
wQ
wQ
wQ
wQ
wQ
wQ
wQ
wQ
wQ
wQ
wQ
wQ
wQ
wQ
wQ
wQ
wQ
wQ
wQ
wQ
wQ
wQ
wQ
wQ
wQ
wQ
wQ
wQ
wQ
wQ
wQ
wQ
wQ
wQ
wQ
wQ
wQ
wQ
"}
(3,1,1) = {"
wQ
wQ
wQ
wQ
wQ
wQ
wQ
wQ
wQ
wQ
wQ
wQ
wQ
wQ
wQ
wQ
wQ
wQ
wQ
wQ
wQ
wQ
wQ
wQ
wQ
wQ
wQ
wQ
wQ
wQ
wQ
wQ
wQ
wQ
wQ
wQ
wQ
wQ
wQ
wQ
wQ
"}
(4,1,1) = {"
wQ
wQ
wQ
wQ
wQ
wQ
wQ
wQ
wQ
wQ
wQ
wQ
wQ
wQ
wQ
wQ
wQ
wQ
wQ
wQ
wQ
wQ
wQ
wQ
wQ
wQ
wQ
wQ
wQ
wQ
wQ
wQ
wQ
wQ
wQ
wQ
wQ
wQ
wQ
wQ
wQ
"}
(5,1,1) = {"
wQ
wQ
wQ
wQ
wQ
wQ
wQ
wQ
wQ
wQ
wQ
wQ
wQ
wQ
wQ
wQ
wQ
wQ
wQ
wQ
wQ
wQ
wQ
wQ
wQ
wQ
wQ
wQ
wQ
wQ
wQ
wQ
wQ
wQ
wQ
wQ
wQ
wQ
wQ
wQ
wQ
"}
(6,1,1) = {"
wQ
wQ
wQ
wQ
wQ
wQ
wQ
wQ
wQ
wQ
wQ
wQ
wQ
wQ
wQ
wQ
wQ
wQ
wQ
wQ
wQ
wQ
wQ
wQ
wQ
wQ
wQ
wQ
wQ
wQ
wQ
wQ
wQ
wQ
wQ
wQ
wQ
wQ
wQ
wQ
wQ
"}
(7,1,1) = {"
wQ
wQ
wQ
wQ
wQ
wQ
wQ
wQ
wQ
wQ
wQ
wQ
wQ
wQ
wQ
wQ
wQ
wQ
wQ
wQ
wQ
wQ
wQ
wQ
wQ
wQ
wQ
wQ
wQ
wQ
wQ
wQ
wQ
wQ
wQ
wQ
wQ
wQ
wQ
wQ
wQ
"}
(8,1,1) = {"
wQ
wQ
wQ
wQ
wQ
wQ
wQ
wQ
wQ
wQ
wQ
wQ
wQ
wQ
wQ
wQ
wQ
wQ
wQ
wQ
wQ
wQ
wQ
wQ
wQ
wQ
wQ
wQ
wQ
wQ
wQ
wQ
wQ
wQ
wQ
wQ
wQ
wQ
wQ
wQ
wQ
"}
(9,1,1) = {"
wQ
wQ
wQ
wQ
wQ
wQ
wQ
wQ
wQ
wQ
wQ
wQ
wQ
wQ
wQ
wQ
wQ
wQ
wQ
wQ
wQ
wQ
wQ
wQ
wQ
wQ
wQ
wQ
wQ
wQ
wQ
wQ
wQ
wQ
wQ
wQ
wQ
wQ
wQ
wQ
wQ
"}
(10,1,1) = {"
wQ
wQ
wQ
wQ
wQ
wQ
wQ
wQ
wQ
wQ
wQ
wQ
wQ
wQ
wQ
wQ
wQ
wQ
wQ
wQ
wQ
wQ
wQ
wQ
wQ
wQ
wQ
wQ
wQ
wQ
wQ
wQ
wQ
wQ
wQ
wQ
wQ
wQ
wQ
wQ
wQ
"}
(11,1,1) = {"
wQ
wQ
wQ
wQ
wQ
wQ
wQ
wQ
wQ
wQ
wQ
wQ
wQ
wQ
wQ
wQ
wQ
wQ
wQ
wQ
wQ
wQ
wQ
wQ
wQ
wQ
wQ
wQ
wQ
wQ
wQ
wQ
wQ
wQ
wQ
wQ
wQ
wQ
wQ
wQ
wQ
"}
(12,1,1) = {"
wQ
wQ
wQ
wQ
wQ
wQ
wQ
wQ
wQ
wQ
wQ
wQ
wQ
wQ
wQ
wQ
wQ
wQ
wQ
wQ
wQ
wQ
wQ
wQ
wQ
wQ
wQ
wQ
wQ
wQ
wQ
wQ
wQ
wQ
wQ
wQ
wQ
wQ
wQ
wQ
wQ
"}
(13,1,1) = {"
wQ
wQ
wQ
wQ
wQ
wQ
wQ
wQ
wQ
wQ
wQ
wQ
wQ
wQ
wQ
wQ
wQ
wQ
wQ
wQ
wQ
ZL
wQ
wQ
wQ
wQ
wQ
wQ
wQ
wQ
wQ
wQ
wQ
wQ
wQ
wQ
wQ
wQ
wQ
wQ
wQ
"}
(14,1,1) = {"
wQ
wQ
wQ
wQ
wQ
wQ
wQ
wQ
wQ
wQ
wQ
wQ
wQ
wQ
wQ
wQ
wQ
wQ
wQ
wQ
ZL
ZL
ZL
wQ
wQ
wQ
wQ
wQ
wQ
wQ
wQ
wQ
wQ
wQ
wQ
wQ
wQ
wQ
wQ
wQ
wQ
"}
(15,1,1) = {"
wQ
wQ
wQ
wQ
wQ
wQ
wQ
wQ
wQ
wQ
wQ
wQ
wQ
wQ
wQ
wQ
wQ
wQ
wQ
wQ
ZL
kt
ZL
ZL
wQ
wQ
wQ
wQ
wQ
wQ
wQ
wQ
wQ
wQ
wQ
wQ
wQ
wQ
wQ
wQ
wQ
"}
(16,1,1) = {"
wQ
wQ
wQ
wQ
wQ
wQ
wQ
ZL
fH
fH
fH
fH
fH
cg
cg
cg
WQ
WQ
WQ
WQ
XD
By
xu
cg
cg
cg
cg
wQ
wQ
wQ
wQ
wQ
wQ
wQ
wQ
wQ
wQ
wQ
wQ
wQ
wQ
"}
(17,1,1) = {"
wQ
wQ
wQ
wQ
wQ
wQ
ZL
ZL
fH
xJ
xJ
xJ
xJ
cg
BS
BS
WQ
vW
GF
WQ
ZL
ZL
ZL
fn
op
xG
cg
cg
wQ
wQ
wQ
wQ
wQ
wQ
wQ
wQ
wQ
wQ
wQ
wQ
wQ
"}
(18,1,1) = {"
wQ
wQ
wQ
wQ
wQ
wQ
ZL
ZL
fH
Vd
Dr
xJ
qc
cg
vg
Lx
WQ
YZ
YZ
WQ
ZL
hq
ZL
yx
Yv
AB
cg
cg
cg
wQ
wQ
wQ
wQ
wQ
wQ
wQ
wQ
wQ
wQ
wQ
wQ
"}
(19,1,1) = {"
wQ
wQ
wQ
wQ
wQ
wQ
wQ
ZL
YK
ZL
dj
xJ
Hk
IS
Lx
ro
Ek
vi
AB
WQ
ZL
Yv
ZL
Yv
Yv
AB
cg
cg
cg
cg
wQ
wQ
wQ
wQ
wQ
wQ
wQ
wQ
wQ
wQ
wQ
"}
(20,1,1) = {"
wQ
wQ
wQ
wQ
wQ
wQ
wQ
ZL
XD
kt
wM
wM
Gy
cg
vg
Lx
WQ
qL
zx
WQ
Yv
Yv
Yv
cg
Lx
AB
cg
cg
cg
cg
cg
wQ
wQ
wQ
wQ
wQ
wQ
wQ
wQ
wQ
wQ
"}
(21,1,1) = {"
wQ
wQ
wQ
wQ
wQ
wQ
wQ
wQ
xu
ZL
wM
wM
uX
cg
cg
IS
WQ
WQ
WQ
WQ
AB
AB
cg
cg
AB
AB
cg
cg
cg
cg
cg
wQ
wQ
wQ
wQ
wQ
wQ
wQ
wQ
wQ
wQ
"}
(22,1,1) = {"
wQ
wQ
wQ
wQ
wQ
wQ
wQ
ZL
By
By
hq
dj
uX
cg
uE
Lx
OQ
AB
oX
zk
AB
AB
FP
cg
Pl
Yv
cg
CI
hq
Td
cg
hn
wQ
wQ
wQ
wQ
wQ
wQ
wQ
wQ
wQ
"}
(23,1,1) = {"
wQ
wQ
wQ
wQ
wQ
wQ
wQ
wQ
ua
fr
ZL
wM
lO
cg
Pk
AB
AB
Lx
AB
wv
Lx
AB
FP
cg
Yv
Yv
TO
hq
ZL
hq
Pi
ZL
ZL
wQ
wQ
wQ
wQ
wQ
wQ
wQ
wQ
"}
(24,1,1) = {"
wQ
wQ
wQ
wQ
wQ
wQ
wQ
ZL
ZL
ZL
By
IH
wM
cg
br
Lx
vR
Vi
YF
Zu
AB
AB
FP
cg
gP
Yv
cg
hn
ZL
Td
cg
hn
wQ
wQ
wQ
wQ
wQ
wQ
wQ
wQ
wQ
"}
(25,1,1) = {"
wQ
wQ
wQ
wQ
wQ
wQ
ZL
ZL
xu
ZL
fr
Fi
mb
cg
cg
IS
cg
cg
cg
cg
AB
Lx
lS
cg
cg
cg
cg
cg
cg
cg
cg
wQ
wQ
wQ
wQ
wQ
wQ
wQ
wQ
wQ
wQ
"}
(26,1,1) = {"
wQ
wQ
wQ
wQ
wQ
wQ
wQ
ZL
By
ZL
By
WC
mb
cg
bI
AB
Lx
AB
oS
cg
cg
Sq
cg
cg
ib
eb
cg
cg
cg
cg
cg
wQ
wQ
wQ
wQ
wQ
wQ
wQ
wQ
wQ
wQ
"}
(27,1,1) = {"
wQ
wQ
wQ
wQ
wQ
wQ
wQ
wQ
ua
ZL
ZL
ZL
mb
cg
Tb
AB
KT
AB
Lx
IS
AB
AB
AB
IS
AB
Lx
cg
cg
cg
cg
wQ
wQ
wQ
wQ
wQ
wQ
wQ
wQ
wQ
wQ
wQ
"}
(28,1,1) = {"
wQ
wQ
wQ
wQ
wQ
wQ
wQ
wQ
XD
fr
kt
ZL
lN
cg
tT
lJ
bX
pl
oS
cg
AB
Lx
AB
cg
cg
zW
cg
cg
cg
wQ
wQ
wQ
wQ
wQ
wQ
wQ
wQ
wQ
wQ
wQ
wQ
"}
(29,1,1) = {"
wQ
wQ
wQ
wQ
wQ
wQ
wQ
ZL
xu
ZL
By
ZL
wa
cg
uE
AB
Yr
qM
Ih
cg
kM
aF
eL
cg
HI
cb
cg
cg
wQ
wQ
wQ
wQ
wQ
wQ
wQ
wQ
wQ
wQ
wQ
wQ
wQ
"}
(30,1,1) = {"
wQ
wQ
wQ
wQ
wQ
wQ
wQ
ZL
ZL
YK
ZL
xu
YK
xu
cg
cg
cg
cg
cg
cg
cg
cg
cg
cg
cg
cg
cg
wQ
wQ
wQ
wQ
wQ
wQ
wQ
wQ
wQ
wQ
wQ
wQ
wQ
wQ
"}
(31,1,1) = {"
wQ
wQ
wQ
wQ
wQ
wQ
wQ
ZL
wQ
ZL
wQ
ZL
ZL
ZL
ZL
wQ
wQ
wQ
wQ
wQ
wQ
wQ
wQ
wQ
wQ
wQ
wQ
wQ
wQ
wQ
wQ
wQ
wQ
wQ
wQ
wQ
wQ
wQ
wQ
wQ
wQ
"}
(32,1,1) = {"
wQ
wQ
wQ
wQ
wQ
wQ
wQ
wQ
wQ
wQ
wQ
wQ
ZL
ZL
ZL
wQ
wQ
wQ
wQ
wQ
wQ
wQ
wQ
wQ
wQ
wQ
wQ
wQ
wQ
wQ
wQ
wQ
wQ
wQ
wQ
wQ
wQ
wQ
wQ
wQ
wQ
"}
(33,1,1) = {"
wQ
wQ
wQ
wQ
wQ
wQ
wQ
wQ
wQ
wQ
wQ
wQ
wQ
wQ
wQ
wQ
wQ
wQ
wQ
wQ
wQ
wQ
wQ
wQ
wQ
wQ
wQ
wQ
wQ
wQ
wQ
wQ
wQ
wQ
wQ
wQ
wQ
wQ
wQ
wQ
wQ
"}
(34,1,1) = {"
wQ
wQ
wQ
wQ
wQ
wQ
wQ
wQ
wQ
wQ
wQ
wQ
wQ
wQ
wQ
wQ
wQ
wQ
wQ
wQ
wQ
wQ
wQ
wQ
wQ
wQ
wQ
wQ
wQ
wQ
wQ
wQ
wQ
wQ
wQ
wQ
wQ
wQ
wQ
wQ
wQ
"}
(35,1,1) = {"
wQ
wQ
wQ
wQ
wQ
wQ
wQ
wQ
wQ
wQ
wQ
wQ
wQ
wQ
wQ
wQ
wQ
wQ
wQ
wQ
wQ
wQ
wQ
wQ
wQ
wQ
wQ
wQ
wQ
wQ
wQ
wQ
wQ
wQ
wQ
wQ
wQ
wQ
wQ
wQ
wQ
"}
(36,1,1) = {"
wQ
wQ
wQ
wQ
wQ
wQ
wQ
wQ
wQ
wQ
wQ
wQ
wQ
wQ
wQ
wQ
wQ
wQ
wQ
wQ
wQ
wQ
wQ
wQ
wQ
wQ
wQ
wQ
wQ
wQ
wQ
wQ
wQ
wQ
wQ
wQ
wQ
wQ
wQ
wQ
wQ
"}
(37,1,1) = {"
wQ
wQ
wQ
wQ
wQ
wQ
wQ
wQ
wQ
wQ
wQ
wQ
wQ
wQ
wQ
wQ
wQ
wQ
wQ
wQ
wQ
wQ
wQ
wQ
wQ
wQ
wQ
wQ
wQ
wQ
wQ
wQ
wQ
wQ
wQ
wQ
wQ
wQ
wQ
wQ
wQ
"}
(38,1,1) = {"
wQ
wQ
wQ
wQ
wQ
wQ
wQ
wQ
wQ
wQ
wQ
wQ
wQ
wQ
wQ
wQ
wQ
wQ
wQ
wQ
wQ
wQ
wQ
wQ
wQ
wQ
wQ
wQ
wQ
wQ
wQ
wQ
wQ
wQ
wQ
wQ
wQ
wQ
wQ
wQ
wQ
"}
(39,1,1) = {"
wQ
wQ
wQ
wQ
wQ
wQ
wQ
wQ
wQ
wQ
wQ
wQ
wQ
wQ
wQ
wQ
wQ
wQ
wQ
wQ
wQ
wQ
wQ
wQ
wQ
wQ
wQ
wQ
wQ
wQ
wQ
wQ
wQ
wQ
wQ
wQ
wQ
wQ
wQ
wQ
wQ
"}
(40,1,1) = {"
wQ
wQ
wQ
wQ
wQ
wQ
wQ
wQ
wQ
wQ
wQ
wQ
wQ
wQ
wQ
wQ
wQ
wQ
wQ
wQ
wQ
wQ
wQ
wQ
wQ
wQ
wQ
wQ
wQ
wQ
wQ
wQ
wQ
wQ
wQ
wQ
wQ
wQ
wQ
wQ
wQ
"}
(41,1,1) = {"
wQ
wQ
wQ
wQ
wQ
wQ
wQ
wQ
wQ
wQ
wQ
wQ
wQ
wQ
wQ
wQ
wQ
wQ
wQ
wQ
wQ
wQ
wQ
wQ
wQ
wQ
wQ
wQ
wQ
wQ
wQ
wQ
wQ
wQ
wQ
wQ
wQ
wQ
wQ
wQ
wQ
"}
(42,1,1) = {"
wQ
wQ
wQ
wQ
wQ
wQ
wQ
wQ
wQ
wQ
wQ
wQ
wQ
wQ
wQ
wQ
wQ
wQ
wQ
wQ
wQ
wQ
wQ
wQ
wQ
wQ
wQ
wQ
wQ
wQ
wQ
wQ
wQ
wQ
wQ
wQ
wQ
wQ
wQ
wQ
wQ
"}
(43,1,1) = {"
wQ
wQ
wQ
wQ
wQ
wQ
wQ
wQ
wQ
wQ
wQ
wQ
wQ
wQ
wQ
wQ
wQ
wQ
wQ
wQ
wQ
wQ
wQ
wQ
wQ
wQ
wQ
wQ
wQ
wQ
wQ
wQ
wQ
wQ
wQ
wQ
wQ
wQ
wQ
wQ
wQ
"}
(44,1,1) = {"
wQ
wQ
wQ
wQ
wQ
wQ
wQ
wQ
wQ
wQ
wQ
wQ
wQ
wQ
wQ
wQ
wQ
wQ
wQ
wQ
wQ
wQ
wQ
wQ
wQ
wQ
wQ
wQ
wQ
wQ
wQ
wQ
wQ
wQ
wQ
wQ
wQ
wQ
wQ
wQ
wQ
"}
