//MAP CONVERTED BY dmm2tgm.py THIS HEADER COMMENT PREVENTS RECONVERSION, DO NOT REMOVE
"a" = (
/turf/template_noop,
/area/space)
"c" = (
/turf/simulated/mineral/ice,
/area/space)
"d" = (
/obj/landmark/no_weather_here,
/obj/landmark/corpse/ice_cave,
/turf/simulated/floor/exoplanet/ice,
/area/space)
"e" = (
/turf/simulated/floor/exoplanet/ice,
/area/space)
"g" = (
/obj/landmark/no_weather_here,
/obj/structure/ice_rock,
/turf/simulated/floor/exoplanet/ice,
/area/space)
"j" = (
/obj/landmark/no_weather_here,
/obj/anomaly/electra/three_and_three/tesla_second,
/turf/simulated/floor/exoplanet/ice,
/area/space)
"n" = (
/obj/landmark/no_weather_here,
/obj/structure/ice_rock,
/obj/anomaly/electra/three_and_three/tesla_second,
/turf/simulated/floor/exoplanet/ice,
/area/space)
"t" = (
/obj/landmark/corpse/ice_cave,
/turf/simulated/floor/exoplanet/ice,
/area/space)
"y" = (
/obj/structure/ice_rock,
/obj/anomaly/electra/three_and_three/tesla_second,
/turf/simulated/floor/exoplanet/ice,
/area/space)
"A" = (
/obj/structure/ice_rock,
/turf/simulated/floor/exoplanet/ice,
/area/space)
"E" = (
/obj/anomaly/electra/three_and_three/tesla_second,
/turf/space,
/area/space)
"J" = (
/obj/landmark/no_weather_here,
/obj/item/aurora_key,
/turf/simulated/floor/exoplanet/ice,
/area/space)
"M" = (
/obj/landmark/no_weather_here,
/turf/simulated/mineral/ice,
/area/space)
"P" = (
/obj/landmark/no_weather_here,
/obj/structure/ice_rock,
/obj/landmark/corpse/ice_cave,
/turf/simulated/floor/exoplanet/ice,
/area/space)
"R" = (
/obj/landmark/no_weather_here,
/turf/simulated/floor/exoplanet/ice,
/area/space)
"W" = (
/obj/anomaly/electra/three_and_three/tesla_second,
/turf/simulated/floor/exoplanet/ice,
/area/space)

(1,1,1) = {"
a
a
a
a
a
a
a
a
a
a
a
a
a
a
a
a
a
a
a
a
a
a
a
a
a
a
a
a
a
a
"}
(2,1,1) = {"
a
a
a
a
a
a
a
a
a
a
a
a
a
a
a
a
a
a
e
e
e
a
a
a
a
a
a
a
a
a
"}
(3,1,1) = {"
a
a
a
a
a
a
a
a
a
a
a
a
a
a
a
a
a
e
e
W
e
a
a
a
a
a
a
a
a
a
"}
(4,1,1) = {"
a
a
a
a
a
a
a
a
a
a
a
a
a
a
a
a
e
e
M
t
R
c
a
a
a
a
a
a
a
a
"}
(5,1,1) = {"
a
a
a
a
a
a
a
a
a
a
a
a
a
a
a
a
R
M
M
R
R
c
a
a
a
a
a
a
a
a
"}
(6,1,1) = {"
a
a
a
a
a
a
a
a
a
a
a
a
a
c
c
c
g
R
R
R
c
c
c
c
c
a
a
a
a
a
"}
(7,1,1) = {"
a
a
a
a
a
a
a
a
a
a
a
c
c
c
c
c
R
R
R
R
c
c
c
c
c
c
a
a
a
a
"}
(8,1,1) = {"
a
a
a
a
a
a
a
a
a
c
c
c
c
c
c
c
R
n
R
c
c
c
c
c
c
c
a
a
a
a
"}
(9,1,1) = {"
a
a
a
a
a
a
a
c
c
c
c
c
c
c
c
c
R
R
R
c
c
c
c
c
c
a
a
a
a
a
"}
(10,1,1) = {"
a
a
a
a
a
a
c
c
c
c
c
c
c
c
c
R
R
d
R
c
c
c
c
a
a
a
a
a
a
a
"}
(11,1,1) = {"
a
a
a
a
a
c
c
c
c
c
c
c
c
c
c
R
R
R
R
c
c
c
c
a
c
a
a
a
a
a
"}
(12,1,1) = {"
a
a
a
a
a
c
c
c
c
c
c
c
c
c
R
R
R
R
R
c
c
c
c
c
c
a
a
a
a
a
"}
(13,1,1) = {"
a
a
a
a
a
c
c
c
c
R
R
R
R
R
R
R
c
R
R
c
c
c
c
c
c
a
a
a
a
a
"}
(14,1,1) = {"
a
a
a
a
a
c
c
c
R
R
g
R
d
R
R
c
R
R
R
c
c
c
c
c
c
c
a
a
a
a
"}
(15,1,1) = {"
a
a
a
a
a
c
c
c
R
R
R
R
R
R
R
c
c
R
R
c
c
c
c
c
c
c
c
a
a
a
"}
(16,1,1) = {"
a
a
a
a
a
c
c
c
c
R
J
R
g
R
c
c
R
R
R
c
c
c
c
c
c
c
c
a
a
a
"}
(17,1,1) = {"
a
a
a
a
a
c
c
c
c
R
d
R
R
R
c
R
R
R
R
c
c
c
c
c
c
c
c
a
a
a
"}
(18,1,1) = {"
a
a
a
a
a
c
c
c
c
R
R
R
R
R
c
c
c
R
R
c
c
c
c
c
c
c
c
c
a
a
"}
(19,1,1) = {"
a
a
a
a
a
c
c
c
c
R
R
c
c
R
c
c
c
R
g
c
c
c
c
c
c
c
c
c
a
a
"}
(20,1,1) = {"
a
a
a
a
a
a
c
c
c
c
c
c
c
c
c
c
R
R
R
c
c
c
c
c
a
c
c
c
a
a
"}
(21,1,1) = {"
a
a
a
a
a
a
a
c
c
c
c
c
c
c
c
c
g
g
R
c
c
c
c
c
a
a
a
a
a
a
"}
(22,1,1) = {"
a
a
a
a
a
a
a
a
c
c
c
c
c
c
c
R
R
R
R
c
c
c
c
a
a
a
a
a
a
a
"}
(23,1,1) = {"
a
a
a
a
a
a
a
a
a
c
c
c
c
c
R
j
R
R
R
c
c
c
c
c
a
a
a
a
a
a
"}
(24,1,1) = {"
a
a
a
a
a
a
a
a
a
a
a
e
e
e
e
R
R
P
R
c
c
c
c
c
c
c
a
a
a
a
"}
(25,1,1) = {"
a
a
a
a
a
a
a
a
a
a
a
e
W
e
t
e
e
R
R
c
c
c
c
c
c
c
a
a
a
a
"}
(26,1,1) = {"
a
a
a
a
a
a
a
a
a
a
a
e
e
e
a
e
t
e
e
c
c
a
c
c
c
c
c
a
a
a
"}
(27,1,1) = {"
a
a
a
a
a
a
a
a
a
e
e
e
a
e
e
e
A
e
e
e
a
a
c
c
c
c
c
a
a
a
"}
(28,1,1) = {"
a
a
a
a
a
a
a
a
a
e
W
e
a
e
E
e
e
e
y
e
e
a
a
a
a
a
a
a
a
a
"}
(29,1,1) = {"
a
a
a
a
a
a
a
a
a
e
e
e
a
e
e
e
a
e
e
e
a
a
a
a
a
a
a
a
a
a
"}
(30,1,1) = {"
a
a
a
a
a
a
a
a
a
a
a
a
a
a
a
a
a
a
a
a
a
a
a
a
a
a
a
a
a
a
"}
