//MAP CONVERTED BY dmm2tgm.py THIS HEADER COMMENT PREVENTS RECONVERSION, DO NOT REMOVE
"bj" = (
/obj/item/clothing/suit/space/void/ceti/alt,
/obj/item/clothing/suit/space/void/ceti/alt,
/obj/item/clothing/suit/space/void/ceti/alt,
/obj/item/clothing/suit/space/void/ceti/alt,
/obj/item/clothing/suit/space/void/ceti/alt,
/obj/item/clothing/suit/space/void/ceti/alt,
/obj/item/clothing/suit/space/void/ceti/alt,
/obj/item/clothing/suit/space/void/ceti/alt,
/obj/item/clothing/suit/space/void/ceti/alt,
/obj/item/clothing/suit/space/void/ceti/alt,
/obj/item/clothing/suit/space/void/ceti/alt,
/obj/item/clothing/suit/space/void/ceti/alt,
/obj/item/clothing/suit/space/void/ceti/alt,
/obj/item/clothing/suit/space/void/ceti/alt,
/obj/item/clothing/suit/space/void/ceti/alt,
/obj/item/clothing/suit/space/void/ceti/alt,
/obj/item/clothing/suit/space/void/ceti/alt,
/obj/item/clothing/suit/space/void/ceti/alt,
/obj/item/clothing/suit/space/void/ceti/alt,
/obj/item/clothing/suit/space/void/ceti/alt,
/obj/item/clothing/suit/space/void/ceti/alt,
/obj/structure/table/rack,
/turf/simulated/floor/lino,
/area/map_template/playtest_anomaly)
"dL" = (
/obj/structure/dispenser/oxygen,
/turf/simulated/floor/lino,
/area/map_template/playtest_anomaly)
"kV" = (
/obj/item/device/gps,
/obj/item/device/gps,
/obj/item/device/gps,
/obj/item/device/gps,
/obj/item/device/gps,
/obj/item/device/gps,
/obj/item/device/gps,
/obj/item/device/gps,
/obj/item/device/gps,
/obj/item/device/gps,
/obj/item/device/gps,
/obj/item/device/gps,
/obj/item/device/gps,
/obj/item/device/gps,
/obj/item/device/gps,
/obj/item/device/gps,
/obj/item/device/gps,
/obj/item/device/gps,
/obj/item/device/gps,
/obj/item/device/gps,
/obj/item/device/gps,
/obj/item/device/gps,
/obj/item/device/gps,
/obj/structure/table/rack,
/turf/simulated/floor/lino,
/area/map_template/playtest_anomaly)
"kX" = (
/obj/item/artefact_detector,
/obj/item/artefact_detector,
/obj/item/artefact_detector,
/obj/item/artefact_detector,
/obj/item/artefact_detector,
/obj/item/artefact_detector,
/obj/item/artefact_detector,
/obj/item/artefact_detector,
/obj/item/artefact_detector,
/obj/item/artefact_detector,
/obj/item/artefact_detector,
/obj/item/artefact_detector,
/obj/item/artefact_detector,
/obj/item/artefact_detector,
/obj/item/artefact_detector,
/obj/item/artefact_detector,
/obj/item/artefact_detector,
/obj/item/artefact_detector,
/obj/item/artefact_detector,
/obj/item/artefact_detector,
/obj/item/artefact_detector,
/obj/item/artefact_detector,
/obj/item/artefact_detector,
/obj/item/artefact_detector,
/obj/item/artefact_detector,
/obj/item/artefact_detector,
/obj/structure/table/rack,
/turf/simulated/floor/lino,
/area/map_template/playtest_anomaly)
"lw" = (
/obj/item/storage/belt/holster/machete,
/obj/item/storage/belt/holster/machete,
/obj/item/storage/belt/holster/machete,
/obj/item/storage/belt/holster/machete,
/obj/item/storage/belt/holster/machete,
/obj/item/storage/belt/holster/machete,
/obj/item/storage/belt/holster/machete,
/obj/item/storage/belt/holster/machete,
/obj/item/storage/belt/holster/machete,
/obj/item/storage/belt/holster/machete,
/obj/item/storage/belt/holster/machete,
/obj/item/storage/belt/holster/machete,
/obj/item/storage/belt/holster/machete,
/obj/item/storage/belt/holster/machete,
/obj/item/storage/belt/holster/machete,
/obj/item/storage/belt/holster/machete,
/obj/item/storage/belt/holster/machete,
/obj/item/storage/belt/holster/machete,
/obj/item/storage/belt/holster/machete,
/obj/item/storage/belt/holster/machete,
/obj/item/storage/belt/holster/machete,
/obj/item/storage/belt/holster/machete,
/obj/item/storage/belt/holster/machete,
/obj/item/storage/belt/holster/machete,
/obj/item/storage/belt/holster/machete,
/obj/item/storage/belt/holster/machete,
/obj/item/storage/belt/holster/machete,
/obj/item/storage/belt/holster/machete,
/obj/item/storage/belt/holster/machete,
/obj/item/storage/belt/holster/machete,
/obj/item/storage/belt/holster/machete,
/obj/item/storage/belt/holster/machete,
/obj/item/storage/belt/holster/machete,
/obj/item/storage/belt/holster/machete,
/obj/item/storage/belt/holster/machete,
/obj/item/storage/belt/holster/machete,
/obj/item/storage/belt/holster/machete,
/obj/item/storage/belt/holster/machete,
/obj/item/storage/belt/holster/machete,
/obj/item/storage/belt/holster/machete,
/obj/item/storage/belt/holster/machete,
/obj/item/storage/belt/holster/machete,
/obj/item/storage/belt/holster/machete,
/obj/item/storage/belt/holster/machete,
/obj/item/storage/belt/holster/machete,
/obj/item/storage/belt/holster/machete,
/obj/structure/table/rack,
/turf/simulated/floor/lino,
/area/map_template/playtest_anomaly)
"mu" = (
/obj/machinery/door/airlock,
/obj/mech_shield,
/turf/simulated/floor/lino,
/area/map_template/playtest_anomaly)
"nd" = (
/obj/machinery/portable_atmospherics/canister/oxygen,
/turf/simulated/floor/lino,
/area/map_template/playtest_anomaly)
"oC" = (
/obj/structure/table/rack,
/obj/item/clothing/head/helmet/space/void/ceti/alt,
/obj/item/clothing/head/helmet/space/void/ceti/alt,
/obj/item/clothing/head/helmet/space/void/ceti/alt,
/obj/item/clothing/head/helmet/space/void/ceti/alt,
/obj/item/clothing/head/helmet/space/void/ceti/alt,
/obj/item/clothing/head/helmet/space/void/ceti/alt,
/obj/item/clothing/head/helmet/space/void/ceti/alt,
/obj/item/clothing/head/helmet/space/void/ceti/alt,
/obj/item/clothing/head/helmet/space/void/ceti/alt,
/obj/item/clothing/head/helmet/space/void/ceti/alt,
/obj/item/clothing/head/helmet/space/void/ceti/alt,
/obj/item/clothing/head/helmet/space/void/ceti/alt,
/obj/item/clothing/head/helmet/space/void/ceti/alt,
/obj/item/clothing/head/helmet/space/void/ceti/alt,
/obj/item/clothing/head/helmet/space/void/ceti/alt,
/obj/item/clothing/head/helmet/space/void/ceti/alt,
/obj/item/clothing/head/helmet/space/void/ceti/alt,
/obj/item/clothing/head/helmet/space/void/ceti/alt,
/obj/item/clothing/head/helmet/space/void/ceti/alt,
/obj/item/clothing/head/helmet/space/void/ceti/alt,
/obj/item/clothing/head/helmet/space/void/ceti/alt,
/obj/item/clothing/head/helmet/space/void/ceti/alt,
/obj/item/clothing/head/helmet/space/void/ceti/alt,
/obj/item/clothing/head/helmet/space/void/ceti/alt,
/turf/simulated/floor/lino,
/area/map_template/playtest_anomaly)
"oE" = (
/obj/item/clothing/gloves/anomaly_detector,
/obj/item/clothing/gloves/anomaly_detector,
/obj/item/clothing/gloves/anomaly_detector,
/obj/item/clothing/gloves/anomaly_detector,
/obj/item/clothing/gloves/anomaly_detector,
/obj/item/clothing/gloves/anomaly_detector,
/obj/item/clothing/gloves/anomaly_detector,
/obj/item/clothing/gloves/anomaly_detector,
/obj/item/clothing/gloves/anomaly_detector,
/obj/item/clothing/gloves/anomaly_detector,
/obj/item/clothing/gloves/anomaly_detector,
/obj/item/clothing/gloves/anomaly_detector,
/obj/item/clothing/gloves/anomaly_detector,
/obj/item/clothing/gloves/anomaly_detector,
/obj/item/clothing/gloves/anomaly_detector,
/obj/item/clothing/gloves/anomaly_detector,
/obj/item/clothing/gloves/anomaly_detector,
/obj/item/clothing/gloves/anomaly_detector,
/obj/item/clothing/gloves/anomaly_detector,
/obj/item/clothing/gloves/anomaly_detector,
/obj/item/clothing/gloves/anomaly_detector,
/obj/structure/table/rack,
/turf/simulated/floor/lino,
/area/map_template/playtest_anomaly)
"qV" = (
/turf/unsimulated/wall,
/area/map_template/playtest_anomaly)
"tQ" = (
/turf/simulated/floor/lino,
/area/map_template/playtest_anomaly)
"ym" = (
/turf/template_noop,
/area/space)
"GH" = (
/obj/item/storage/bolt_bag/full_of_beacons,
/obj/item/storage/bolt_bag/full_of_beacons,
/obj/item/storage/bolt_bag/full_of_beacons,
/obj/item/storage/bolt_bag/full_of_beacons,
/obj/item/storage/bolt_bag/full_of_beacons,
/obj/item/storage/bolt_bag/full_of_beacons,
/obj/item/storage/bolt_bag/full_of_beacons,
/obj/item/storage/bolt_bag/full_of_beacons,
/obj/item/storage/bolt_bag/full_of_beacons,
/obj/item/storage/bolt_bag/full_of_beacons,
/obj/item/storage/bolt_bag/full_of_beacons,
/obj/item/storage/bolt_bag/full_of_beacons,
/obj/item/storage/bolt_bag/full_of_beacons,
/obj/item/storage/bolt_bag/full_of_beacons,
/obj/item/storage/bolt_bag/full_of_beacons,
/obj/item/storage/bolt_bag/full_of_beacons,
/obj/item/storage/bolt_bag/full_of_beacons,
/obj/item/storage/bolt_bag/full_of_beacons,
/obj/item/storage/bolt_bag/full_of_beacons,
/obj/item/storage/bolt_bag/full_of_beacons,
/obj/item/storage/bolt_bag/full_of_beacons,
/obj/item/storage/bolt_bag/full_of_beacons,
/obj/item/storage/bolt_bag/full_of_beacons,
/obj/item/storage/bolt_bag/full_of_beacons,
/obj/item/storage/bolt_bag/full_of_beacons,
/obj/item/storage/bolt_bag/full_of_beacons,
/obj/item/storage/bolt_bag/full_of_beacons,
/obj/item/storage/bolt_bag/full_of_beacons,
/obj/item/storage/bolt_bag/full_of_beacons,
/obj/item/storage/bolt_bag/full_of_beacons,
/obj/item/storage/bolt_bag/full_of_beacons,
/obj/structure/table/rack,
/turf/simulated/floor/lino,
/area/map_template/playtest_anomaly)
"Hi" = (
/obj/item/clothing/under/tactical,
/obj/item/clothing/under/tactical,
/obj/item/clothing/under/tactical,
/obj/item/clothing/under/tactical,
/obj/item/clothing/under/tactical,
/obj/item/clothing/under/tactical,
/obj/item/clothing/under/tactical,
/obj/item/clothing/under/tactical,
/obj/item/clothing/under/tactical,
/obj/item/clothing/under/tactical,
/obj/item/clothing/under/tactical,
/obj/item/clothing/under/tactical,
/obj/item/clothing/under/tactical,
/obj/item/clothing/under/tactical,
/obj/item/clothing/under/tactical,
/obj/structure/table/rack,
/turf/simulated/floor/lino,
/area/map_template/playtest_anomaly)
"Ms" = (
/obj/structute/join_the_playtest,
/turf/simulated/floor/lino,
/area/map_template/playtest_anomaly)
"Py" = (
/obj/item/beacon_deployer/full,
/obj/item/beacon_deployer/full,
/obj/item/beacon_deployer/full,
/obj/item/beacon_deployer/full,
/obj/item/beacon_deployer/full,
/obj/item/beacon_deployer/full,
/obj/item/beacon_deployer/full,
/obj/item/beacon_deployer/full,
/obj/item/beacon_deployer/full,
/obj/item/beacon_deployer/full,
/obj/item/beacon_deployer/full,
/obj/item/beacon_deployer/full,
/obj/item/beacon_deployer/full,
/obj/item/beacon_deployer/full,
/obj/item/beacon_deployer/full,
/obj/item/beacon_deployer/full,
/obj/item/beacon_deployer/full,
/obj/item/beacon_deployer/full,
/obj/item/beacon_deployer/full,
/obj/item/beacon_deployer/full,
/obj/item/beacon_deployer/full,
/obj/item/beacon_deployer/full,
/obj/item/beacon_deployer/full,
/obj/item/beacon_deployer/full,
/obj/item/beacon_deployer/full,
/obj/item/beacon_deployer/full,
/obj/item/beacon_deployer/full,
/obj/item/beacon_deployer/full,
/obj/item/beacon_deployer/full,
/obj/item/beacon_deployer/full,
/obj/item/beacon_deployer/full,
/obj/item/beacon_deployer/full,
/obj/item/beacon_deployer/full,
/obj/item/beacon_deployer/full,
/obj/item/beacon_deployer/full,
/obj/item/beacon_deployer/full,
/obj/item/beacon_deployer/full,
/obj/item/beacon_deployer/full,
/obj/item/beacon_deployer/full,
/obj/item/beacon_deployer/full,
/obj/item/beacon_deployer/full,
/obj/item/beacon_deployer/full,
/obj/item/beacon_deployer/full,
/obj/item/beacon_deployer/full,
/obj/item/beacon_deployer/full,
/obj/item/beacon_deployer/full,
/obj/item/beacon_deployer/full,
/obj/item/beacon_deployer/full,
/obj/item/beacon_deployer/full,
/obj/item/beacon_deployer/full,
/obj/item/beacon_deployer/full,
/obj/item/beacon_deployer/full,
/obj/item/beacon_deployer/full,
/obj/item/beacon_deployer/full,
/obj/item/beacon_deployer/full,
/obj/structure/table/rack,
/turf/simulated/floor/lino,
/area/map_template/playtest_anomaly)
"Qb" = (
/obj/mech_shield,
/turf/simulated/floor/lino,
/area/map_template/playtest_anomaly)
"WW" = (
/obj/item/melee/energy/machete,
/obj/item/melee/energy/machete,
/obj/item/melee/energy/machete,
/obj/item/melee/energy/machete,
/obj/item/melee/energy/machete,
/obj/item/melee/energy/machete,
/obj/item/melee/energy/machete,
/obj/item/melee/energy/machete,
/obj/item/melee/energy/machete,
/obj/item/melee/energy/machete,
/obj/item/melee/energy/machete,
/obj/item/melee/energy/machete,
/obj/item/melee/energy/machete,
/obj/item/melee/energy/machete,
/obj/item/melee/energy/machete,
/obj/item/melee/energy/machete,
/obj/item/melee/energy/machete,
/obj/item/melee/energy/machete,
/obj/item/melee/energy/machete,
/obj/item/melee/energy/machete,
/obj/item/melee/energy/machete,
/obj/item/melee/energy/machete,
/obj/item/melee/energy/machete,
/obj/item/melee/energy/machete,
/obj/item/melee/energy/machete,
/obj/structure/table/rack,
/turf/simulated/floor/lino,
/area/map_template/playtest_anomaly)

(1,1,1) = {"
qV
qV
qV
qV
qV
qV
ym
"}
(2,1,1) = {"
qV
qV
kV
dL
qV
qV
ym
"}
(3,1,1) = {"
qV
Hi
tQ
tQ
dL
qV
ym
"}
(4,1,1) = {"
qV
Py
tQ
tQ
tQ
qV
ym
"}
(5,1,1) = {"
qV
oE
tQ
tQ
tQ
qV
qV
"}
(6,1,1) = {"
qV
GH
tQ
tQ
tQ
Qb
qV
"}
(7,1,1) = {"
qV
kX
tQ
tQ
tQ
Qb
mu
"}
(8,1,1) = {"
qV
bj
tQ
Ms
tQ
Qb
qV
"}
(9,1,1) = {"
qV
oC
tQ
tQ
tQ
qV
qV
"}
(10,1,1) = {"
qV
lw
tQ
tQ
tQ
qV
ym
"}
(11,1,1) = {"
qV
WW
tQ
tQ
nd
qV
ym
"}
(12,1,1) = {"
qV
qV
nd
nd
qV
qV
ym
"}
(13,1,1) = {"
qV
qV
qV
qV
qV
qV
ym
"}
