//MAP CONVERTED BY dmm2tgm.py THIS HEADER COMMENT PREVENTS RECONVERSION, DO NOT REMOVE
"aO" = (
/obj/machinery/door/blast/regular{
	id_tag = "colblast"
	},
/obj/fluid/deep,
/turf/simulated/floor/tiled/monotile,
/area/map_template/skat_underwater)
"aY" = (
/obj/fluid/deep,
/turf/simulated/floor/tiled/monotile,
/area/map_template/skat_underwater)
"cE" = (
/obj/structure/rubble/house,
/obj/random/trash,
/obj/random/trash,
/obj/random/trash,
/obj/fluid/deep,
/turf/simulated/floor/tiled/monotile,
/area/map_template/skat_underwater)
"dX" = (
/obj/structure/railing/mapped,
/obj/fluid/deep,
/turf/simulated/floor/tiled/monotile,
/area/map_template/skat_underwater)
"ei" = (
/obj/landmark/random_titan_crate,
/obj/fluid/deep,
/turf/simulated/floor/tiled/monotile,
/area/map_template/skat_underwater)
"em" = (
/obj/landmark/teleport_to_z_level/skat/exit,
/obj/fluid/deep,
/turf/simulated/floor/tiled/monotile,
/area/map_template/skat_underwater)
"fM" = (
/turf/simulated/floor/exoplanet/titan_water/maximum{
	density = 1;
	opacity = 1
	},
/area/space)
"gh" = (
/turf/simulated/floor/tiled/monotile,
/area/map_template/skat_underwater)
"hL" = (
/obj/structure/water_drown_structures/paper,
/obj/fluid/deep,
/turf/simulated/floor/tiled/monotile,
/area/map_template/skat_underwater)
"nB" = (
/obj/structure/railing/mapped{
	dir = 8
	},
/obj/fluid/deep,
/turf/simulated/floor/tiled/monotile,
/area/map_template/skat_underwater)
"rR" = (
/turf/simulated/floor/exoplanet/titan_water/maximum,
/area/space)
"uf" = (
/turf/simulated/floor/exoplanet/titan_water/maximum{
	density = 1;
	opacity = 1;
	name = "edge of world"
	},
/area/space)
"vf" = (
/obj/fluid/deep,
/turf/simulated/floor/exoplanet/titan_water/middle,
/area/map_template/skat_underwater)
"vK" = (
/obj/structure/water_drown_structures/wooden_planks,
/obj/fluid/deep,
/turf/simulated/floor/tiled/monotile,
/area/map_template/skat_underwater)
"wk" = (
/obj/machinery/door/blast/regular{
	id_tag = "colblast"
	},
/turf/simulated/floor/tiled/monotile,
/area/map_template/skat_underwater)
"wJ" = (
/obj/structure/water_drown_structures,
/obj/fluid/deep,
/turf/simulated/floor/tiled/monotile,
/area/map_template/skat_underwater)
"wT" = (
/obj/structure/rubble/house,
/obj/random/trash,
/obj/fluid/deep,
/turf/simulated/floor/tiled/monotile,
/area/map_template/skat_underwater)
"Gt" = (
/obj/structure/water_drown_structures/wooden_crates_damaged,
/obj/fluid/deep,
/turf/simulated/floor/tiled/monotile,
/area/map_template/skat_underwater)
"HM" = (
/obj/floor_decal/stairs{
	dir = 1
	},
/obj/fluid/deep,
/turf/simulated/floor/tiled/monotile,
/area/map_template/skat_underwater)
"Ka" = (
/obj/structure/railing/mapped{
	dir = 4
	},
/obj/fluid/deep,
/turf/simulated/floor/tiled/monotile,
/area/map_template/skat_underwater)
"Mu" = (
/turf/simulated/wall/r_wall/hull,
/area/map_template/skat_underwater)
"QH" = (
/obj/fluid/deep,
/turf/simulated/floor/exoplanet/titan_water/maximum,
/area/map_template/skat_underwater)
"Uy" = (
/obj/machinery/atmospherics/unary/engine{
	dir = 8
	},
/turf/simulated/wall/r_wall/hull,
/area/map_template/skat_underwater)
"UH" = (
/obj/structure/rubble/house,
/obj/fluid/deep,
/turf/simulated/floor/tiled/monotile,
/area/map_template/skat_underwater)
"YL" = (
/turf/simulated/floor/exoplanet/titan_water/maximum,
/area/map_template/skat_underwater)

(1,1,1) = {"
uf
uf
uf
uf
uf
uf
uf
uf
uf
uf
uf
uf
uf
uf
uf
uf
uf
uf
uf
uf
uf
uf
uf
uf
uf
uf
uf
uf
uf
uf
uf
uf
uf
uf
uf
uf
uf
uf
uf
uf
"}
(2,1,1) = {"
uf
fM
rR
rR
rR
rR
rR
rR
rR
rR
rR
rR
rR
rR
rR
rR
rR
rR
rR
rR
rR
rR
rR
rR
rR
rR
rR
rR
rR
rR
rR
rR
rR
rR
rR
rR
rR
rR
uf
uf
"}
(3,1,1) = {"
uf
fM
rR
rR
rR
rR
rR
rR
rR
rR
rR
uf
uf
uf
uf
uf
uf
uf
uf
uf
uf
uf
uf
uf
uf
uf
uf
uf
rR
rR
rR
rR
rR
rR
rR
rR
rR
rR
uf
uf
"}
(4,1,1) = {"
uf
fM
rR
rR
rR
rR
rR
rR
rR
rR
rR
rR
Mu
Mu
aO
aO
aO
aO
aO
aO
aO
aO
aO
aO
aO
wk
Mu
Mu
rR
rR
rR
rR
rR
rR
rR
rR
rR
rR
uf
uf
"}
(5,1,1) = {"
uf
fM
rR
rR
rR
rR
rR
rR
rR
rR
rR
rR
Mu
Mu
aO
aO
aO
aO
aO
aO
aO
aO
aO
aO
aO
wk
Mu
Mu
rR
rR
rR
rR
rR
rR
rR
rR
rR
rR
uf
uf
"}
(6,1,1) = {"
uf
fM
rR
rR
rR
rR
rR
rR
rR
rR
rR
Mu
Mu
Mu
aO
aO
aO
aO
aO
aO
aO
aO
aO
aO
aO
wk
Mu
Mu
Mu
rR
rR
rR
rR
rR
rR
rR
rR
rR
uf
uf
"}
(7,1,1) = {"
uf
fM
rR
rR
rR
rR
rR
rR
rR
rR
rR
Mu
Mu
Mu
aY
aY
aY
aY
aY
aY
aY
aY
aY
aY
aY
gh
Mu
Mu
Mu
rR
rR
rR
rR
rR
rR
rR
rR
rR
uf
uf
"}
(8,1,1) = {"
uf
fM
rR
rR
rR
rR
rR
rR
rR
rR
rR
Mu
Mu
Mu
Gt
aY
aY
aY
aY
aY
aY
aY
aY
Gt
aY
gh
Mu
Mu
Mu
rR
rR
rR
rR
rR
rR
rR
rR
rR
uf
uf
"}
(9,1,1) = {"
uf
fM
rR
rR
rR
rR
rR
rR
rR
rR
Mu
Mu
Mu
Mu
aY
aY
aY
Gt
aY
aY
Gt
aY
ei
aY
aY
gh
Mu
Mu
Mu
Mu
rR
rR
rR
rR
rR
rR
rR
rR
uf
uf
"}
(10,1,1) = {"
uf
fM
rR
rR
rR
rR
rR
rR
rR
rR
Mu
Mu
Mu
Mu
aY
aY
aY
aY
ei
aY
aY
aY
aY
aY
aY
gh
Mu
Mu
Mu
Mu
rR
rR
rR
rR
rR
rR
rR
rR
uf
uf
"}
(11,1,1) = {"
uf
fM
rR
rR
rR
rR
rR
rR
rR
Mu
Mu
Mu
Mu
Mu
aY
aY
aY
aY
aY
aY
aY
Gt
aY
aY
Gt
gh
Mu
Mu
Mu
Mu
Mu
rR
rR
rR
rR
rR
rR
rR
uf
uf
"}
(12,1,1) = {"
uf
fM
rR
rR
rR
rR
rR
rR
rR
Mu
Mu
Mu
Mu
Mu
aY
Gt
aY
aY
aY
aY
aY
aY
aY
aY
aY
gh
Mu
Mu
Mu
Mu
Mu
rR
rR
rR
rR
rR
rR
rR
uf
uf
"}
(13,1,1) = {"
uf
fM
rR
rR
rR
rR
rR
rR
rR
Mu
Mu
Mu
Mu
Mu
aY
aY
aY
aY
vK
aY
aY
Gt
aY
aY
aY
gh
Mu
Mu
Mu
Mu
Mu
rR
rR
rR
rR
rR
rR
rR
uf
uf
"}
(14,1,1) = {"
uf
fM
rR
rR
rR
rR
rR
rR
rR
Mu
Mu
Mu
Mu
Mu
aY
aY
aY
aY
aY
ei
aY
aY
aY
aY
aY
gh
Mu
Mu
Mu
Mu
Mu
rR
rR
rR
rR
rR
rR
rR
uf
uf
"}
(15,1,1) = {"
uf
fM
rR
rR
rR
rR
rR
rR
rR
Mu
Mu
Mu
aY
aY
aY
vK
aY
Gt
aY
aY
aY
aY
aY
aY
Gt
aY
aY
aY
Mu
Mu
Mu
rR
rR
rR
rR
rR
rR
rR
uf
uf
"}
(16,1,1) = {"
uf
fM
rR
rR
rR
rR
rR
rR
Mu
Mu
Mu
Mu
aY
Gt
aY
aY
aY
aY
aY
aY
aY
vK
vK
aY
aY
aY
aY
aY
Mu
Mu
Mu
Mu
rR
rR
rR
rR
rR
rR
uf
uf
"}
(17,1,1) = {"
uf
fM
rR
rR
rR
rR
rR
rR
Mu
Mu
Mu
Mu
aY
aY
aY
aY
ei
aY
vK
aY
aY
aY
aY
aY
aY
aY
aY
Gt
Mu
Mu
Mu
Mu
rR
rR
rR
rR
rR
rR
uf
uf
"}
(18,1,1) = {"
uf
fM
rR
rR
rR
rR
rR
rR
Mu
Mu
Mu
Mu
aY
aY
Gt
aY
aY
aY
aY
aY
Gt
aY
aY
ei
aY
aY
aY
aY
Mu
Mu
Mu
Mu
rR
rR
rR
rR
rR
rR
uf
uf
"}
(19,1,1) = {"
uf
fM
rR
rR
rR
rR
rR
rR
Mu
Mu
Mu
Mu
aY
aY
aY
aY
Gt
aY
aY
aY
aY
aY
aY
aY
aY
vK
aY
aY
Mu
Mu
Mu
Mu
rR
rR
rR
rR
rR
rR
uf
uf
"}
(20,1,1) = {"
uf
fM
rR
rR
rR
rR
rR
rR
Mu
Mu
Mu
Mu
vK
aY
aY
aY
aY
aY
aY
vK
aY
aY
vK
vK
aY
aY
ei
aY
Mu
Mu
Mu
Mu
rR
rR
rR
rR
rR
rR
uf
uf
"}
(21,1,1) = {"
uf
fM
rR
rR
rR
rR
rR
rR
Mu
Mu
Mu
Mu
aY
aY
aY
aY
vK
aY
aY
aY
aY
aY
vK
aY
aY
aY
aY
aY
Mu
Mu
Mu
Mu
rR
rR
rR
rR
rR
rR
uf
uf
"}
(22,1,1) = {"
uf
fM
rR
rR
rR
rR
rR
rR
Mu
Mu
Mu
Mu
aY
aY
Gt
aY
aY
aY
Gt
aY
aY
aY
aY
aY
aY
aY
Gt
aY
Mu
Mu
Mu
Mu
rR
rR
rR
rR
rR
rR
uf
uf
"}
(23,1,1) = {"
uf
fM
rR
rR
rR
rR
rR
rR
Mu
Mu
Mu
Mu
aY
aY
aY
aY
ei
aY
aY
aY
aY
aY
aY
ei
aY
aY
aY
aY
Mu
Mu
Mu
Mu
rR
rR
rR
rR
rR
rR
uf
uf
"}
(24,1,1) = {"
uf
fM
rR
rR
rR
rR
rR
Mu
Mu
Mu
Mu
Mu
aY
aY
vK
aY
aY
Gt
aY
aY
vK
aY
vK
aY
vK
aY
aY
aY
Mu
Mu
Mu
Mu
Mu
rR
rR
rR
rR
rR
uf
uf
"}
(25,1,1) = {"
uf
fM
rR
rR
rR
rR
rR
Mu
Mu
Mu
Mu
Mu
aY
aY
aY
aY
aY
aY
aY
aY
ei
aY
aY
aY
aY
aY
ei
aY
Mu
Mu
Mu
Mu
Mu
rR
rR
rR
rR
rR
uf
uf
"}
(26,1,1) = {"
uf
fM
rR
rR
rR
rR
rR
Mu
Mu
Mu
Mu
Mu
Gt
aY
aY
Gt
aY
aY
vK
aY
aY
aY
aY
Gt
Gt
aY
aY
Gt
Mu
Mu
Mu
Mu
Mu
rR
rR
rR
rR
rR
uf
uf
"}
(27,1,1) = {"
uf
fM
rR
rR
rR
rR
rR
Mu
Mu
Mu
Mu
Mu
aY
aY
aY
aY
aY
aY
aY
aY
aY
Gt
aY
aY
aY
aY
aY
aY
Mu
Mu
Mu
Mu
Mu
rR
rR
rR
rR
rR
uf
uf
"}
(28,1,1) = {"
uf
fM
rR
rR
rR
rR
rR
Mu
Mu
Mu
Mu
Mu
aY
aY
aY
Gt
aY
ei
aY
Gt
aY
aY
aY
aY
aY
Gt
aY
ei
Mu
Mu
Mu
Mu
Mu
rR
rR
rR
rR
rR
uf
uf
"}
(29,1,1) = {"
uf
fM
rR
rR
rR
rR
rR
Mu
Mu
Mu
Mu
Mu
aO
aO
aO
aO
aO
aO
aO
aO
aO
aO
aO
aO
aO
aO
aO
aO
Mu
Mu
Mu
Mu
Mu
rR
rR
rR
rR
rR
uf
uf
"}
(30,1,1) = {"
uf
fM
rR
rR
rR
rR
rR
Mu
Mu
Mu
Mu
Mu
aO
aO
aO
aO
aO
aO
aO
aO
aO
aO
aO
aO
aO
aO
aO
aO
Mu
Mu
Mu
Mu
Mu
rR
rR
rR
rR
rR
uf
uf
"}
(31,1,1) = {"
uf
fM
rR
rR
rR
rR
rR
Mu
Mu
Mu
aY
aY
aY
aY
aY
aY
aY
aY
aY
aY
aY
aY
aY
aY
aY
aY
aY
aY
aY
aY
Mu
Mu
Mu
rR
rR
rR
rR
rR
uf
uf
"}
(32,1,1) = {"
uf
fM
rR
rR
rR
rR
rR
Mu
Mu
Mu
aY
aY
aY
aY
aY
vK
aY
aY
aY
aY
aY
aY
aY
ei
aY
aY
aY
aY
aY
aY
Mu
Mu
Mu
rR
rR
rR
rR
rR
uf
uf
"}
(33,1,1) = {"
uf
fM
rR
rR
rR
rR
rR
Mu
Mu
Mu
aY
aY
aY
aY
aY
aY
aY
aY
aY
aY
aY
aY
aY
aY
aY
aY
aY
aY
hL
aY
Mu
Mu
Mu
rR
rR
rR
rR
rR
uf
uf
"}
(34,1,1) = {"
uf
fM
rR
rR
rR
rR
rR
Mu
Mu
Mu
aY
aY
aY
ei
aY
aY
aY
hL
aY
aY
aY
aY
aY
aY
aY
hL
aY
aY
aY
aY
Mu
Mu
Mu
rR
rR
rR
rR
rR
uf
uf
"}
(35,1,1) = {"
uf
fM
rR
rR
rR
rR
rR
Mu
Mu
Mu
wJ
Ka
Ka
aY
aY
vK
aY
aY
ei
aY
aY
aY
aY
aY
aY
aY
aY
wT
cE
aY
Mu
Mu
Mu
rR
rR
rR
rR
rR
uf
uf
"}
(36,1,1) = {"
uf
fM
rR
rR
rR
rR
rR
Mu
Mu
Mu
dX
em
HM
aY
aY
aY
aY
aY
aY
aY
aY
aY
aY
ei
aY
aY
wT
wT
cE
wT
Mu
Mu
Mu
rR
rR
rR
rR
rR
uf
uf
"}
(37,1,1) = {"
uf
fM
rR
rR
rR
rR
rR
Mu
Mu
Mu
dX
aY
HM
aY
wJ
aY
aY
aY
aY
aY
aY
aY
aY
aY
aY
aY
wT
wT
UH
wT
Mu
Mu
Mu
rR
rR
rR
rR
rR
uf
uf
"}
(38,1,1) = {"
uf
fM
rR
rR
rR
rR
rR
Mu
Mu
Mu
vK
nB
nB
aY
aY
wJ
aY
aY
aY
aY
aY
aY
aY
aY
aY
aY
wT
wT
wT
aY
Mu
Mu
Mu
rR
rR
rR
rR
rR
uf
uf
"}
(39,1,1) = {"
uf
fM
rR
rR
rR
rR
rR
Mu
Mu
Mu
aY
aY
aY
aY
aY
aY
ei
aY
aY
aY
ei
aY
aY
aY
hL
aY
aY
aY
aY
aY
Mu
Mu
Mu
rR
rR
rR
rR
rR
uf
uf
"}
(40,1,1) = {"
uf
fM
rR
rR
rR
rR
rR
Mu
Mu
Mu
aY
aY
aY
aY
aY
aY
aY
aY
hL
aY
aY
aY
aY
aY
aY
aY
aY
aY
aY
aY
Mu
Mu
Mu
rR
rR
rR
rR
rR
uf
uf
"}
(41,1,1) = {"
uf
fM
rR
rR
rR
rR
rR
Mu
Mu
Mu
aY
QH
vf
aY
ei
aY
aY
ei
aY
aY
aY
ei
aY
ei
aY
aY
aY
vf
QH
aY
Mu
Mu
Mu
rR
rR
rR
rR
rR
uf
uf
"}
(42,1,1) = {"
uf
fM
rR
rR
rR
rR
rR
Mu
Mu
Mu
aY
QH
vf
aY
aY
aY
aY
aY
aY
aY
ei
aY
aY
aY
aY
aY
aY
vf
QH
aY
Mu
Mu
Mu
rR
rR
rR
rR
rR
uf
uf
"}
(43,1,1) = {"
uf
fM
rR
rR
rR
rR
rR
Mu
Mu
Mu
aY
aY
aY
aY
aY
aY
aY
aY
ei
aY
aY
aY
aY
aY
aY
aY
aY
aY
aY
aY
Mu
Mu
Mu
rR
rR
rR
rR
rR
uf
uf
"}
(44,1,1) = {"
uf
fM
rR
rR
rR
rR
rR
Mu
Mu
Mu
aY
aY
aY
aY
aY
aY
aY
aY
aY
vK
aY
aY
aY
aY
vK
aY
aY
aY
aY
hL
Mu
Mu
Mu
rR
rR
rR
rR
rR
uf
uf
"}
(45,1,1) = {"
uf
fM
rR
rR
rR
rR
rR
Mu
Mu
Mu
aY
aY
aY
aY
aY
aY
aY
aY
aY
aY
aY
aY
aY
aY
aY
aY
ei
aY
aY
aY
Mu
Mu
Mu
rR
rR
rR
rR
rR
uf
uf
"}
(46,1,1) = {"
uf
fM
rR
rR
rR
rR
rR
Mu
Mu
Mu
aY
aY
ei
aY
aY
aY
ei
aY
aY
aY
aY
aY
ei
aY
aY
hL
aY
aY
aY
aY
Mu
Mu
Mu
rR
rR
rR
rR
rR
uf
uf
"}
(47,1,1) = {"
uf
fM
rR
rR
rR
rR
rR
Mu
Mu
Mu
vK
aY
aY
aY
hL
aY
aY
hL
aY
aY
aY
aY
aY
aY
aY
aY
aY
aY
aY
aY
Mu
Mu
Mu
rR
rR
rR
rR
rR
uf
uf
"}
(48,1,1) = {"
uf
fM
rR
rR
rR
rR
rR
Mu
Mu
Mu
aY
aY
aY
aY
aY
aY
aY
aY
aY
aY
aY
aY
aY
aY
aY
aY
aY
aY
aY
aY
Mu
Mu
Mu
rR
rR
rR
rR
rR
uf
uf
"}
(49,1,1) = {"
uf
fM
rR
rR
rR
rR
rR
Mu
Mu
Mu
aY
aY
aY
aY
aY
aY
aY
aY
aY
aY
ei
aY
aY
aY
aY
aY
aY
aY
aY
aY
Mu
Mu
Mu
rR
rR
rR
rR
rR
uf
uf
"}
(50,1,1) = {"
uf
fM
rR
rR
rR
rR
rR
Mu
Mu
Mu
aY
aY
aY
aY
aY
aY
aY
aY
aY
aY
aY
aY
aY
aY
aY
aY
hL
aY
aY
aY
Mu
Mu
Mu
rR
rR
rR
rR
rR
uf
uf
"}
(51,1,1) = {"
uf
fM
rR
rR
rR
rR
Mu
Mu
Mu
Mu
aY
aY
aY
aY
aY
ei
aY
aY
aY
aY
aY
aY
aY
aY
aY
aY
hL
aY
aY
aY
Mu
Mu
Mu
Mu
rR
rR
rR
rR
uf
uf
"}
(52,1,1) = {"
uf
fM
rR
rR
rR
rR
Mu
Mu
Mu
Mu
aY
aY
hL
aY
aY
aY
vK
aY
hL
aY
aY
aY
aY
aY
aY
aY
aY
aY
aY
aY
Mu
Mu
Mu
Mu
rR
rR
rR
rR
uf
uf
"}
(53,1,1) = {"
uf
fM
rR
rR
rR
rR
Mu
Mu
Mu
Mu
aY
aY
aY
aY
aY
aY
aY
aY
aY
aY
aY
aY
hL
aY
ei
aY
aY
aY
aY
aY
Mu
Mu
Mu
Mu
rR
rR
rR
rR
uf
uf
"}
(54,1,1) = {"
uf
fM
rR
rR
rR
rR
Mu
Mu
Mu
Mu
aY
aY
ei
aY
aY
aY
aY
aY
aY
aY
aY
aY
aY
aY
aY
aY
aY
aY
aY
aY
Mu
Mu
Mu
Mu
rR
rR
rR
rR
uf
uf
"}
(55,1,1) = {"
uf
fM
rR
rR
rR
rR
Mu
Mu
Mu
Mu
aY
aY
aY
aY
aY
aY
aY
ei
aY
aY
aY
aY
ei
aY
aY
aY
aY
aY
aY
aY
Mu
Mu
Mu
Mu
rR
rR
rR
rR
uf
uf
"}
(56,1,1) = {"
uf
fM
rR
rR
rR
rR
Mu
Mu
Mu
Mu
aY
aY
aY
aY
aY
aY
aY
aY
aY
aY
aY
aY
aY
aY
aY
aY
aY
aY
hL
aY
Mu
Mu
Mu
Mu
rR
rR
rR
rR
uf
uf
"}
(57,1,1) = {"
uf
fM
rR
Mu
Mu
Mu
Mu
Mu
Mu
Mu
vK
aY
aY
aY
aY
aY
aY
aY
aY
aY
aY
aY
aY
aY
aY
vK
aY
aY
aY
aY
Mu
Mu
Mu
Mu
Mu
Mu
Mu
rR
uf
uf
"}
(58,1,1) = {"
uf
fM
rR
Mu
Mu
Mu
Mu
Mu
Mu
Mu
aY
aY
aY
aY
aY
ei
aY
aY
vK
aY
aY
ei
aY
aY
aY
aY
ei
aY
aY
aY
Mu
Mu
Mu
Mu
Mu
Mu
Mu
rR
uf
uf
"}
(59,1,1) = {"
uf
fM
Mu
Mu
Mu
Mu
Mu
Mu
Mu
Mu
aY
aY
aY
aY
hL
aY
aY
aY
aY
aY
aY
aY
aY
aY
aY
aY
aY
aY
aY
aY
Mu
Mu
Mu
Mu
Mu
Mu
Mu
Mu
uf
uf
"}
(60,1,1) = {"
uf
fM
Mu
Mu
YL
YL
Mu
Mu
Mu
Mu
aY
aY
aY
aY
aY
aY
aY
aY
aY
aY
aY
aY
hL
aY
aY
aY
aY
aY
aY
aY
Mu
Mu
Mu
Mu
YL
YL
Mu
Mu
uf
uf
"}
(61,1,1) = {"
uf
Mu
Mu
Mu
YL
YL
Mu
Mu
Mu
Mu
aY
aY
aY
aY
ei
aY
aY
aY
aY
aY
aY
aY
aY
aY
aY
aY
aY
ei
aY
aY
Mu
Mu
Mu
Mu
YL
YL
Mu
Mu
Mu
uf
"}
(62,1,1) = {"
uf
Mu
Mu
YL
YL
YL
Mu
Mu
Mu
Mu
aY
aY
vK
aY
aY
aY
aY
aY
hL
aY
aY
aY
ei
ei
aY
aY
aY
aY
aY
aY
Mu
Mu
Mu
Mu
YL
YL
YL
Mu
Mu
uf
"}
(63,1,1) = {"
uf
Mu
Mu
YL
YL
YL
Mu
Mu
Mu
Mu
aY
aY
aY
aY
aY
aY
aY
aY
aY
aY
aY
aY
aY
aY
aY
aY
aY
aY
hL
aY
Mu
Mu
Mu
Mu
YL
YL
YL
Mu
Mu
uf
"}
(64,1,1) = {"
uf
Mu
Mu
YL
YL
YL
Mu
Mu
Mu
Mu
aY
aY
aY
aY
aY
aY
ei
aY
aY
aY
aY
aY
aY
aY
aY
ei
aY
aY
aY
aY
Mu
Mu
Mu
Mu
YL
YL
YL
Mu
Mu
uf
"}
(65,1,1) = {"
uf
Mu
Mu
YL
YL
YL
Mu
Mu
Mu
Mu
aY
hL
aY
aY
aY
aY
aY
aY
ei
aY
aY
vK
aY
aY
aY
aY
aY
aY
aY
aY
Mu
Mu
Mu
Mu
YL
YL
YL
Mu
Mu
uf
"}
(66,1,1) = {"
uf
Mu
Mu
YL
YL
YL
Mu
Mu
Mu
Mu
aY
aY
aY
aY
aY
aY
hL
aY
aY
aY
aY
aY
aY
aY
aY
vK
aY
aY
aY
aY
Mu
Mu
Mu
Mu
YL
YL
YL
Mu
Mu
uf
"}
(67,1,1) = {"
uf
Mu
Mu
YL
YL
YL
Mu
Mu
Mu
Mu
aY
aY
aY
ei
aY
aY
aY
aY
aY
aY
aY
ei
aY
aY
aY
aY
aY
aY
aY
aY
Mu
Mu
Mu
Mu
YL
YL
YL
Mu
Mu
uf
"}
(68,1,1) = {"
uf
Mu
Mu
YL
YL
YL
Mu
Mu
Mu
Mu
aY
aY
aY
aY
aY
aY
aY
aY
ei
aY
aY
aY
aY
aY
aY
aY
aY
aY
aY
aY
Mu
Mu
Mu
Mu
YL
YL
YL
Mu
Mu
uf
"}
(69,1,1) = {"
uf
Mu
Mu
YL
YL
YL
Mu
Mu
Mu
Mu
Mu
aY
aY
aY
aY
aY
aY
aY
aY
aY
aY
aY
aY
aY
aY
aY
aY
aY
aY
Mu
Mu
Mu
Mu
Mu
YL
YL
YL
Mu
Mu
uf
"}
(70,1,1) = {"
uf
Mu
Mu
YL
YL
YL
Mu
Mu
Mu
Mu
Mu
aY
aY
aY
aY
aY
aY
aY
aY
aY
aY
aY
aY
aY
aY
aY
aY
aY
aY
Mu
Mu
Mu
Mu
Mu
YL
YL
YL
Mu
Mu
uf
"}
(71,1,1) = {"
uf
Mu
Mu
Uy
Uy
Uy
Mu
Mu
Mu
Mu
Mu
Mu
Mu
Mu
Mu
Mu
Mu
Mu
Mu
Mu
Mu
Mu
Mu
Mu
Mu
Mu
Mu
Mu
Mu
Mu
Mu
Mu
Mu
Mu
Uy
Uy
Uy
Mu
fM
uf
"}
(72,1,1) = {"
uf
fM
Mu
rR
rR
rR
Mu
Mu
Mu
Mu
Mu
Mu
Mu
Mu
Mu
Mu
Mu
Mu
Mu
Mu
Mu
Mu
Mu
Mu
Mu
Mu
Mu
Mu
Mu
Mu
Mu
Mu
Mu
Mu
rR
rR
rR
Mu
fM
uf
"}
(73,1,1) = {"
uf
fM
rR
rR
rR
rR
rR
Mu
Uy
Uy
Uy
Uy
Uy
Uy
Uy
Uy
Uy
Uy
Uy
Uy
Uy
Uy
Uy
Uy
Uy
Uy
Uy
Uy
Uy
Uy
Uy
Mu
Mu
rR
rR
rR
rR
rR
fM
uf
"}
(74,1,1) = {"
uf
fM
rR
rR
rR
rR
rR
rR
rR
rR
rR
rR
rR
rR
rR
rR
rR
rR
rR
rR
rR
rR
rR
rR
rR
rR
rR
rR
rR
rR
rR
rR
rR
rR
rR
rR
rR
rR
fM
uf
"}
(75,1,1) = {"
uf
uf
uf
uf
uf
uf
uf
uf
uf
uf
uf
uf
uf
uf
uf
uf
uf
uf
uf
uf
uf
uf
uf
uf
uf
uf
uf
uf
uf
uf
uf
uf
uf
uf
uf
uf
uf
uf
uf
uf
"}
