//MAP CONVERTED BY dmm2tgm.py THIS HEADER COMMENT PREVENTS RECONVERSION, DO NOT REMOVE
"aY" = (
/turf/space,
/area/space)
"em" = (
/turf/simulated/wall/r_wall/hull,
/area/space)
"fM" = (
/turf/simulated/floor/exoplanet/titan_water/maximum{
	density = 1;
	opacity = 1
	},
/area/space)
"rR" = (
/turf/simulated/floor/exoplanet/titan_water/maximum,
/area/space)
"uf" = (
/turf/simulated/floor/exoplanet/titan_water/maximum{
	density = 1;
	opacity = 1;
	name = "edge of world"
	},
/area/space)
"Mu" = (
/turf/simulated/wall/r_wall/hull,
/area/map_template/skat_underwater)
"Uy" = (
/obj/machinery/atmospherics/unary/engine{
	dir = 8
	},
/turf/simulated/wall/r_wall/hull,
/area/map_template/skat_underwater)
"YL" = (
/turf/simulated/floor/exoplanet/titan_water/maximum,
/area/map_template/skat_underwater)

(1,1,1) = {"
uf
uf
uf
uf
uf
uf
uf
uf
uf
uf
uf
uf
uf
uf
uf
uf
uf
uf
uf
uf
uf
uf
uf
uf
uf
uf
uf
uf
uf
uf
uf
uf
uf
uf
uf
uf
uf
uf
uf
uf
"}
(2,1,1) = {"
uf
fM
rR
rR
rR
rR
rR
rR
rR
rR
rR
rR
rR
rR
rR
rR
rR
rR
rR
rR
rR
rR
rR
rR
rR
rR
rR
rR
rR
rR
rR
rR
rR
rR
rR
rR
rR
rR
uf
uf
"}
(3,1,1) = {"
uf
fM
rR
rR
rR
rR
rR
rR
rR
rR
rR
uf
uf
uf
uf
uf
uf
uf
uf
uf
uf
uf
uf
uf
uf
uf
uf
uf
rR
rR
rR
rR
rR
rR
rR
rR
rR
rR
uf
uf
"}
(4,1,1) = {"
uf
fM
rR
rR
rR
rR
rR
rR
rR
rR
rR
rR
Mu
Mu
em
em
em
em
em
em
em
em
em
em
em
em
Mu
Mu
rR
rR
rR
rR
rR
rR
rR
rR
rR
rR
uf
uf
"}
(5,1,1) = {"
uf
fM
rR
rR
rR
rR
rR
rR
rR
rR
rR
rR
Mu
Mu
em
em
em
em
em
em
em
em
em
em
em
em
Mu
Mu
rR
rR
rR
rR
rR
rR
rR
rR
rR
rR
uf
uf
"}
(6,1,1) = {"
uf
fM
rR
rR
rR
rR
rR
rR
rR
rR
rR
Mu
Mu
Mu
em
em
em
em
em
em
em
em
em
em
em
em
Mu
Mu
Mu
rR
rR
rR
rR
rR
rR
rR
rR
rR
uf
uf
"}
(7,1,1) = {"
uf
fM
rR
rR
rR
rR
rR
rR
rR
rR
rR
Mu
Mu
Mu
em
em
em
em
em
em
em
em
em
em
em
aY
Mu
Mu
Mu
rR
rR
rR
rR
rR
rR
rR
rR
rR
uf
uf
"}
(8,1,1) = {"
uf
fM
rR
rR
rR
rR
rR
rR
rR
rR
rR
Mu
Mu
Mu
aY
aY
aY
aY
aY
aY
aY
aY
aY
aY
aY
aY
Mu
Mu
Mu
rR
rR
rR
rR
rR
rR
rR
rR
rR
uf
uf
"}
(9,1,1) = {"
uf
fM
rR
rR
rR
rR
rR
rR
rR
rR
Mu
Mu
Mu
Mu
aY
aY
aY
aY
aY
aY
aY
aY
aY
aY
aY
aY
Mu
Mu
Mu
Mu
rR
rR
rR
rR
rR
rR
rR
rR
uf
uf
"}
(10,1,1) = {"
uf
fM
rR
rR
rR
rR
rR
rR
rR
rR
Mu
Mu
Mu
Mu
aY
aY
aY
aY
aY
aY
aY
aY
aY
aY
aY
aY
Mu
Mu
Mu
Mu
rR
rR
rR
rR
rR
rR
rR
rR
uf
uf
"}
(11,1,1) = {"
uf
fM
rR
rR
rR
rR
rR
rR
rR
Mu
Mu
Mu
Mu
Mu
aY
aY
aY
aY
aY
aY
aY
aY
aY
aY
aY
aY
Mu
Mu
Mu
Mu
Mu
rR
rR
rR
rR
rR
rR
rR
uf
uf
"}
(12,1,1) = {"
uf
fM
rR
rR
rR
rR
rR
rR
rR
Mu
Mu
Mu
Mu
Mu
aY
aY
aY
aY
aY
aY
aY
aY
aY
aY
aY
aY
Mu
Mu
Mu
Mu
Mu
rR
rR
rR
rR
rR
rR
rR
uf
uf
"}
(13,1,1) = {"
uf
fM
rR
rR
rR
rR
rR
rR
rR
Mu
Mu
Mu
Mu
Mu
aY
aY
aY
aY
aY
aY
aY
aY
aY
aY
aY
aY
Mu
Mu
Mu
Mu
Mu
rR
rR
rR
rR
rR
rR
rR
uf
uf
"}
(14,1,1) = {"
uf
fM
rR
rR
rR
rR
rR
rR
rR
Mu
Mu
Mu
Mu
Mu
aY
aY
aY
aY
aY
aY
aY
aY
aY
aY
aY
aY
Mu
Mu
Mu
Mu
Mu
rR
rR
rR
rR
rR
rR
rR
uf
uf
"}
(15,1,1) = {"
uf
fM
rR
rR
rR
rR
rR
rR
rR
Mu
Mu
Mu
aY
aY
aY
aY
aY
aY
aY
aY
aY
aY
aY
aY
aY
aY
aY
aY
Mu
Mu
Mu
rR
rR
rR
rR
rR
rR
rR
uf
uf
"}
(16,1,1) = {"
uf
fM
rR
rR
rR
rR
rR
rR
Mu
Mu
Mu
Mu
aY
aY
aY
aY
aY
aY
aY
aY
aY
aY
aY
aY
aY
aY
aY
aY
Mu
Mu
Mu
Mu
rR
rR
rR
rR
rR
rR
uf
uf
"}
(17,1,1) = {"
uf
fM
rR
rR
rR
rR
rR
rR
Mu
Mu
Mu
Mu
aY
aY
aY
aY
aY
aY
aY
aY
aY
aY
aY
aY
aY
aY
aY
aY
Mu
Mu
Mu
Mu
rR
rR
rR
rR
rR
rR
uf
uf
"}
(18,1,1) = {"
uf
fM
rR
rR
rR
rR
rR
rR
Mu
Mu
Mu
Mu
aY
aY
aY
aY
aY
aY
aY
aY
aY
aY
aY
aY
aY
aY
aY
aY
Mu
Mu
Mu
Mu
rR
rR
rR
rR
rR
rR
uf
uf
"}
(19,1,1) = {"
uf
fM
rR
rR
rR
rR
rR
rR
Mu
Mu
Mu
Mu
aY
aY
aY
aY
aY
aY
aY
aY
aY
aY
aY
aY
aY
aY
aY
aY
Mu
Mu
Mu
Mu
rR
rR
rR
rR
rR
rR
uf
uf
"}
(20,1,1) = {"
uf
fM
rR
rR
rR
rR
rR
rR
Mu
Mu
Mu
Mu
aY
aY
aY
aY
aY
aY
aY
aY
aY
aY
aY
aY
aY
aY
aY
aY
Mu
Mu
Mu
Mu
rR
rR
rR
rR
rR
rR
uf
uf
"}
(21,1,1) = {"
uf
fM
rR
rR
rR
rR
rR
rR
Mu
Mu
Mu
Mu
aY
aY
aY
aY
aY
aY
aY
aY
aY
aY
aY
aY
aY
aY
aY
aY
Mu
Mu
Mu
Mu
rR
rR
rR
rR
rR
rR
uf
uf
"}
(22,1,1) = {"
uf
fM
rR
rR
rR
rR
rR
rR
Mu
Mu
Mu
Mu
aY
aY
aY
aY
aY
aY
aY
aY
aY
aY
aY
aY
aY
aY
aY
aY
Mu
Mu
Mu
Mu
rR
rR
rR
rR
rR
rR
uf
uf
"}
(23,1,1) = {"
uf
fM
rR
rR
rR
rR
rR
rR
Mu
Mu
Mu
Mu
aY
aY
aY
aY
aY
aY
aY
aY
aY
aY
aY
aY
aY
aY
aY
aY
Mu
Mu
Mu
Mu
rR
rR
rR
rR
rR
rR
uf
uf
"}
(24,1,1) = {"
uf
fM
rR
rR
rR
rR
rR
Mu
Mu
Mu
Mu
Mu
aY
aY
aY
aY
aY
aY
aY
aY
aY
aY
aY
aY
aY
aY
aY
aY
Mu
Mu
Mu
Mu
Mu
rR
rR
rR
rR
rR
uf
uf
"}
(25,1,1) = {"
uf
fM
rR
rR
rR
rR
rR
Mu
Mu
Mu
Mu
Mu
aY
aY
aY
aY
aY
aY
aY
aY
aY
aY
aY
aY
aY
aY
aY
aY
Mu
Mu
Mu
Mu
Mu
rR
rR
rR
rR
rR
uf
uf
"}
(26,1,1) = {"
uf
fM
rR
rR
rR
rR
rR
Mu
Mu
Mu
Mu
Mu
aY
aY
aY
aY
aY
aY
aY
aY
aY
aY
aY
aY
aY
aY
aY
aY
Mu
Mu
Mu
Mu
Mu
rR
rR
rR
rR
rR
uf
uf
"}
(27,1,1) = {"
uf
fM
rR
rR
rR
rR
rR
Mu
Mu
Mu
Mu
Mu
aY
aY
aY
aY
aY
aY
aY
aY
aY
aY
aY
aY
aY
aY
aY
aY
Mu
Mu
Mu
Mu
Mu
rR
rR
rR
rR
rR
uf
uf
"}
(28,1,1) = {"
uf
fM
rR
rR
rR
rR
rR
Mu
Mu
Mu
Mu
Mu
aY
aY
aY
aY
aY
aY
aY
aY
aY
aY
aY
aY
aY
aY
aY
aY
Mu
Mu
Mu
Mu
Mu
rR
rR
rR
rR
rR
uf
uf
"}
(29,1,1) = {"
uf
fM
rR
rR
rR
rR
rR
Mu
Mu
Mu
Mu
Mu
aY
aY
aY
aY
aY
aY
aY
aY
aY
aY
aY
aY
aY
aY
aY
aY
Mu
Mu
Mu
Mu
Mu
rR
rR
rR
rR
rR
uf
uf
"}
(30,1,1) = {"
uf
fM
rR
rR
rR
rR
rR
Mu
Mu
Mu
Mu
Mu
aY
aY
aY
aY
aY
aY
aY
aY
aY
aY
aY
aY
aY
aY
aY
aY
Mu
Mu
Mu
Mu
Mu
rR
rR
rR
rR
rR
uf
uf
"}
(31,1,1) = {"
uf
fM
rR
rR
rR
rR
rR
Mu
Mu
Mu
em
em
aY
aY
aY
aY
aY
aY
aY
aY
aY
aY
aY
aY
aY
aY
aY
aY
em
em
Mu
Mu
Mu
rR
rR
rR
rR
rR
uf
uf
"}
(32,1,1) = {"
uf
fM
rR
rR
rR
rR
rR
Mu
Mu
Mu
em
em
aY
aY
aY
aY
aY
aY
aY
aY
aY
aY
aY
aY
aY
aY
aY
aY
em
em
Mu
Mu
Mu
rR
rR
rR
rR
rR
uf
uf
"}
(33,1,1) = {"
uf
fM
rR
rR
rR
rR
rR
Mu
Mu
Mu
em
em
aY
aY
aY
aY
aY
aY
aY
aY
aY
aY
aY
aY
aY
aY
aY
aY
em
em
Mu
Mu
Mu
rR
rR
rR
rR
rR
uf
uf
"}
(34,1,1) = {"
uf
fM
rR
rR
rR
rR
rR
Mu
Mu
Mu
em
em
aY
aY
aY
aY
aY
aY
aY
aY
aY
aY
aY
aY
aY
aY
aY
aY
em
em
Mu
Mu
Mu
rR
rR
rR
rR
rR
uf
uf
"}
(35,1,1) = {"
uf
fM
rR
rR
rR
rR
rR
Mu
Mu
Mu
em
em
aY
aY
aY
aY
aY
aY
aY
aY
aY
aY
aY
aY
aY
aY
aY
aY
em
em
Mu
Mu
Mu
rR
rR
rR
rR
rR
uf
uf
"}
(36,1,1) = {"
uf
fM
rR
rR
rR
rR
rR
Mu
Mu
Mu
em
em
aY
aY
aY
aY
aY
aY
aY
aY
aY
aY
aY
aY
aY
aY
aY
aY
em
em
Mu
Mu
Mu
rR
rR
rR
rR
rR
uf
uf
"}
(37,1,1) = {"
uf
fM
rR
rR
rR
rR
rR
Mu
Mu
Mu
em
em
aY
aY
aY
aY
aY
aY
aY
aY
aY
aY
aY
aY
aY
aY
aY
aY
em
em
Mu
Mu
Mu
rR
rR
rR
rR
rR
uf
uf
"}
(38,1,1) = {"
uf
fM
rR
rR
rR
rR
rR
Mu
Mu
Mu
em
em
aY
aY
aY
aY
aY
aY
aY
aY
aY
aY
aY
aY
aY
aY
aY
aY
em
em
Mu
Mu
Mu
rR
rR
rR
rR
rR
uf
uf
"}
(39,1,1) = {"
uf
fM
rR
rR
rR
rR
rR
Mu
Mu
Mu
em
em
aY
aY
aY
aY
aY
aY
aY
aY
aY
aY
aY
aY
aY
aY
aY
aY
em
em
Mu
Mu
Mu
rR
rR
rR
rR
rR
uf
uf
"}
(40,1,1) = {"
uf
fM
rR
rR
rR
rR
rR
Mu
Mu
Mu
em
em
aY
aY
aY
aY
aY
aY
aY
aY
aY
aY
aY
aY
aY
aY
aY
aY
em
em
Mu
Mu
Mu
rR
rR
rR
rR
rR
uf
uf
"}
(41,1,1) = {"
uf
fM
rR
rR
rR
rR
rR
Mu
Mu
Mu
em
em
aY
aY
aY
aY
aY
aY
aY
aY
aY
aY
aY
aY
aY
aY
aY
aY
em
em
Mu
Mu
Mu
rR
rR
rR
rR
rR
uf
uf
"}
(42,1,1) = {"
uf
fM
rR
rR
rR
rR
rR
Mu
Mu
Mu
em
em
aY
aY
aY
aY
aY
aY
aY
aY
aY
aY
aY
aY
aY
aY
aY
aY
em
em
Mu
Mu
Mu
rR
rR
rR
rR
rR
uf
uf
"}
(43,1,1) = {"
uf
fM
rR
rR
rR
rR
rR
Mu
Mu
Mu
em
em
aY
aY
aY
aY
aY
aY
aY
aY
aY
aY
aY
aY
aY
aY
aY
aY
em
em
Mu
Mu
Mu
rR
rR
rR
rR
rR
uf
uf
"}
(44,1,1) = {"
uf
fM
rR
rR
rR
rR
rR
Mu
Mu
Mu
em
em
aY
aY
aY
aY
aY
aY
aY
aY
aY
aY
aY
aY
aY
aY
aY
aY
em
em
Mu
Mu
Mu
rR
rR
rR
rR
rR
uf
uf
"}
(45,1,1) = {"
uf
fM
rR
rR
rR
rR
rR
Mu
Mu
Mu
em
em
aY
aY
aY
aY
aY
aY
aY
aY
aY
aY
aY
aY
aY
aY
aY
aY
em
em
Mu
Mu
Mu
rR
rR
rR
rR
rR
uf
uf
"}
(46,1,1) = {"
uf
fM
rR
rR
rR
rR
rR
Mu
Mu
Mu
em
em
aY
aY
aY
aY
aY
aY
aY
aY
aY
aY
aY
aY
aY
aY
aY
aY
em
em
Mu
Mu
Mu
rR
rR
rR
rR
rR
uf
uf
"}
(47,1,1) = {"
uf
fM
rR
rR
rR
rR
rR
Mu
Mu
Mu
em
em
aY
aY
aY
aY
aY
aY
aY
aY
aY
aY
aY
aY
aY
aY
aY
aY
em
em
Mu
Mu
Mu
rR
rR
rR
rR
rR
uf
uf
"}
(48,1,1) = {"
uf
fM
rR
rR
rR
rR
rR
Mu
Mu
Mu
em
em
aY
aY
aY
aY
aY
aY
aY
aY
aY
aY
aY
aY
aY
aY
aY
aY
em
em
Mu
Mu
Mu
rR
rR
rR
rR
rR
uf
uf
"}
(49,1,1) = {"
uf
fM
rR
rR
rR
rR
rR
Mu
Mu
Mu
em
em
aY
aY
aY
aY
aY
aY
aY
aY
aY
aY
aY
aY
aY
aY
aY
aY
em
em
Mu
Mu
Mu
rR
rR
rR
rR
rR
uf
uf
"}
(50,1,1) = {"
uf
fM
rR
rR
rR
rR
rR
Mu
Mu
Mu
em
em
aY
aY
aY
aY
aY
aY
aY
aY
aY
aY
aY
aY
aY
aY
aY
aY
em
em
Mu
Mu
Mu
rR
rR
rR
rR
rR
uf
uf
"}
(51,1,1) = {"
uf
fM
rR
rR
rR
rR
Mu
Mu
Mu
Mu
em
em
aY
aY
aY
aY
aY
aY
aY
aY
aY
aY
aY
aY
aY
aY
aY
aY
em
em
Mu
Mu
Mu
Mu
rR
rR
rR
rR
uf
uf
"}
(52,1,1) = {"
uf
fM
rR
rR
rR
rR
Mu
Mu
Mu
Mu
em
em
aY
aY
aY
aY
aY
aY
aY
aY
aY
aY
aY
aY
aY
aY
aY
aY
em
em
Mu
Mu
Mu
Mu
rR
rR
rR
rR
uf
uf
"}
(53,1,1) = {"
uf
fM
rR
rR
rR
rR
Mu
Mu
Mu
Mu
em
em
aY
aY
aY
aY
aY
aY
aY
aY
aY
aY
aY
aY
aY
aY
aY
aY
em
em
Mu
Mu
Mu
Mu
rR
rR
rR
rR
uf
uf
"}
(54,1,1) = {"
uf
fM
rR
rR
rR
rR
Mu
Mu
Mu
Mu
em
em
aY
aY
aY
aY
aY
aY
aY
aY
aY
aY
aY
aY
aY
aY
aY
aY
em
em
Mu
Mu
Mu
Mu
rR
rR
rR
rR
uf
uf
"}
(55,1,1) = {"
uf
fM
rR
rR
rR
rR
Mu
Mu
Mu
Mu
em
em
aY
aY
aY
aY
aY
aY
aY
aY
aY
aY
aY
aY
aY
aY
aY
aY
em
em
Mu
Mu
Mu
Mu
rR
rR
rR
rR
uf
uf
"}
(56,1,1) = {"
uf
fM
rR
rR
rR
rR
Mu
Mu
Mu
Mu
em
em
aY
aY
aY
aY
aY
aY
aY
aY
aY
aY
aY
aY
aY
aY
aY
aY
em
em
Mu
Mu
Mu
Mu
rR
rR
rR
rR
uf
uf
"}
(57,1,1) = {"
uf
fM
rR
Mu
Mu
Mu
Mu
Mu
Mu
Mu
em
em
aY
aY
aY
aY
aY
aY
aY
aY
aY
aY
aY
aY
aY
aY
aY
aY
em
em
Mu
Mu
Mu
Mu
Mu
Mu
Mu
rR
uf
uf
"}
(58,1,1) = {"
uf
fM
rR
Mu
Mu
Mu
Mu
Mu
Mu
Mu
em
em
aY
aY
aY
aY
aY
aY
aY
aY
aY
aY
aY
aY
aY
aY
aY
aY
em
em
Mu
Mu
Mu
Mu
Mu
Mu
Mu
rR
uf
uf
"}
(59,1,1) = {"
uf
fM
Mu
Mu
Mu
Mu
Mu
Mu
Mu
Mu
em
em
aY
aY
aY
aY
aY
aY
aY
aY
aY
aY
aY
aY
aY
aY
aY
aY
em
em
Mu
Mu
Mu
Mu
Mu
Mu
Mu
Mu
uf
uf
"}
(60,1,1) = {"
uf
fM
Mu
Mu
YL
YL
Mu
Mu
Mu
Mu
em
em
aY
aY
aY
aY
aY
aY
aY
aY
aY
aY
aY
aY
aY
aY
aY
aY
em
em
Mu
Mu
Mu
Mu
YL
YL
Mu
Mu
uf
uf
"}
(61,1,1) = {"
uf
Mu
Mu
Mu
YL
YL
Mu
Mu
Mu
Mu
em
em
aY
aY
aY
aY
aY
aY
aY
aY
aY
aY
aY
aY
aY
aY
aY
aY
em
em
Mu
Mu
Mu
Mu
YL
YL
Mu
Mu
Mu
uf
"}
(62,1,1) = {"
uf
Mu
Mu
YL
YL
YL
Mu
Mu
Mu
Mu
em
em
aY
aY
aY
aY
aY
aY
aY
aY
aY
aY
aY
aY
aY
aY
aY
aY
em
em
Mu
Mu
Mu
Mu
YL
YL
YL
Mu
Mu
uf
"}
(63,1,1) = {"
uf
Mu
Mu
YL
YL
YL
Mu
Mu
Mu
Mu
em
em
aY
aY
aY
aY
aY
aY
aY
aY
aY
aY
aY
aY
aY
aY
aY
aY
em
em
Mu
Mu
Mu
Mu
YL
YL
YL
Mu
Mu
uf
"}
(64,1,1) = {"
uf
Mu
Mu
YL
YL
YL
Mu
Mu
Mu
Mu
em
em
aY
aY
aY
aY
aY
aY
aY
aY
aY
aY
aY
aY
aY
aY
aY
aY
em
em
Mu
Mu
Mu
Mu
YL
YL
YL
Mu
Mu
uf
"}
(65,1,1) = {"
uf
Mu
Mu
YL
YL
YL
Mu
Mu
Mu
Mu
em
em
aY
aY
aY
aY
aY
aY
aY
aY
aY
aY
aY
aY
aY
aY
aY
aY
em
em
Mu
Mu
Mu
Mu
YL
YL
YL
Mu
Mu
uf
"}
(66,1,1) = {"
uf
Mu
Mu
YL
YL
YL
Mu
Mu
Mu
Mu
em
em
aY
aY
aY
aY
aY
aY
aY
aY
aY
aY
aY
aY
aY
aY
aY
aY
em
em
Mu
Mu
Mu
Mu
YL
YL
YL
Mu
Mu
uf
"}
(67,1,1) = {"
uf
Mu
Mu
YL
YL
YL
Mu
Mu
Mu
Mu
em
em
aY
aY
aY
aY
aY
aY
aY
aY
aY
aY
aY
aY
aY
aY
aY
aY
em
em
Mu
Mu
Mu
Mu
YL
YL
YL
Mu
Mu
uf
"}
(68,1,1) = {"
uf
Mu
Mu
YL
YL
YL
Mu
Mu
Mu
Mu
em
em
aY
aY
aY
aY
aY
aY
aY
aY
aY
aY
aY
aY
aY
aY
aY
aY
em
em
Mu
Mu
Mu
Mu
YL
YL
YL
Mu
Mu
uf
"}
(69,1,1) = {"
uf
Mu
Mu
YL
YL
YL
Mu
Mu
Mu
Mu
Mu
em
aY
aY
aY
aY
aY
aY
aY
aY
aY
aY
aY
aY
aY
aY
aY
aY
em
Mu
Mu
Mu
Mu
Mu
YL
YL
YL
Mu
Mu
uf
"}
(70,1,1) = {"
uf
Mu
Mu
YL
YL
YL
Mu
Mu
Mu
Mu
Mu
em
aY
aY
aY
aY
aY
aY
aY
aY
aY
aY
aY
aY
aY
aY
aY
aY
em
Mu
Mu
Mu
Mu
Mu
YL
YL
YL
Mu
Mu
uf
"}
(71,1,1) = {"
uf
Mu
Mu
Uy
Uy
Uy
Mu
Mu
Mu
Mu
Mu
Mu
Mu
Mu
Mu
Mu
Mu
Mu
Mu
Mu
Mu
Mu
Mu
Mu
Mu
Mu
Mu
Mu
Mu
Mu
Mu
Mu
Mu
Mu
Uy
Uy
Uy
Mu
fM
uf
"}
(72,1,1) = {"
uf
fM
Mu
rR
rR
rR
Mu
Mu
Mu
Mu
Mu
Mu
Mu
Mu
Mu
Mu
Mu
Mu
Mu
Mu
Mu
Mu
Mu
Mu
Mu
Mu
Mu
Mu
Mu
Mu
Mu
Mu
Mu
Mu
rR
rR
rR
Mu
fM
uf
"}
(73,1,1) = {"
uf
fM
rR
rR
rR
rR
rR
Mu
Uy
Uy
Uy
Uy
Uy
Uy
Uy
Uy
Uy
Uy
Uy
Uy
Uy
Uy
Uy
Uy
Uy
Uy
Uy
Uy
Uy
Uy
Uy
Mu
Mu
rR
rR
rR
rR
rR
fM
uf
"}
(74,1,1) = {"
uf
fM
rR
rR
rR
rR
rR
rR
rR
rR
rR
rR
rR
rR
rR
rR
rR
rR
rR
rR
rR
rR
rR
rR
rR
rR
rR
rR
rR
rR
rR
rR
rR
rR
rR
rR
rR
rR
fM
uf
"}
(75,1,1) = {"
uf
uf
uf
uf
uf
uf
uf
uf
uf
uf
uf
uf
uf
uf
uf
uf
uf
uf
uf
uf
uf
uf
uf
uf
uf
uf
uf
uf
uf
uf
uf
uf
uf
uf
uf
uf
uf
uf
uf
uf
"}
