//MAP CONVERTED BY dmm2tgm.py THIS HEADER COMMENT PREVENTS RECONVERSION, DO NOT REMOVE
"ak" = (
/obj/titan_fluid,
/obj/landmark/titan_crate/rare_crate,
/turf/simulated/floor/plating,
/area/space)
"as" = (
/obj/structure/water_drown_structures/paper,
/obj/titan_fluid,
/turf/simulated/floor/tiled/techfloor/grid,
/area/map_template/anomaly/skat_third_deck)
"aO" = (
/obj/titan_fluid,
/obj/machinery/door/blast/regular/open,
/turf/simulated/floor/exoplanet/titan_water/maximum,
/area/map_template/anomaly/skat_third_deck)
"aY" = (
/obj/titan_fluid,
/turf/simulated/floor/tiled/techfloor/grid,
/area/map_template/anomaly/skat_third_deck)
"bQ" = (
/obj/titan_fluid,
/obj/titan_fluid,
/turf/simulated/wall/r_wall/hull,
/area/map_template/anomaly/skat_third_deck)
"bU" = (
/obj/titan_fluid,
/obj/structure/railing/mapped{
	dir = 4
	},
/obj/floor_decal/industrial/warning/dust{
	dir = 4
	},
/turf/simulated/floor/tiled/monotile,
/area/map_template/anomaly/skat_third_deck)
"cm" = (
/obj/floor_decal/industrial/warning{
	dir = 1
	},
/obj/titan_fluid,
/turf/simulated/floor/tiled/monotile,
/area/map_template/anomaly/skat_third_deck)
"cw" = (
/obj/titan_fluid,
/obj/forcefield/blocker,
/turf/simulated/floor/exoplanet/titan_water/maximum,
/area/map_template/anomaly/skat_third_deck)
"cB" = (
/obj/titan_fluid,
/obj/titan_fluid,
/turf/simulated/floor/tiled/monotile,
/area/map_template/anomaly/skat_third_deck)
"cE" = (
/obj/structure/water_drown_structures/wooden_planks,
/obj/titan_fluid,
/turf/simulated/floor/exoplanet/titan_water/maximum,
/area/map_template/anomaly/skat_third_deck)
"dg" = (
/obj/titan_fluid,
/obj/structure/girder,
/turf/simulated/floor/plating,
/area/map_template/anomaly/skat_third_deck)
"dX" = (
/obj/titan_fluid,
/obj/structure/railing/mapped{
	dir = 4
	},
/turf/simulated/floor/tiled/monotile,
/area/map_template/anomaly/skat_third_deck)
"ei" = (
/obj/titan_fluid,
/obj/landmark/titan_crate/weak_crate,
/turf/simulated/floor/tiled/techfloor/grid,
/area/map_template/anomaly/skat_third_deck)
"em" = (
/obj/titan_fluid,
/obj/mob_spawner/titan_crabs,
/turf/simulated/floor/exoplanet/titan_water/maximum,
/area/map_template/anomaly/skat_third_deck)
"en" = (
/obj/titan_fluid,
/obj/landmark/titan_crate/rare_crate,
/turf/simulated/floor/tiled/techfloor/grid,
/area/map_template/anomaly/skat_third_deck)
"fl" = (
/obj/floor_decal/industrial/warning,
/obj/titan_fluid,
/obj/structure/girder,
/turf/simulated/floor/tiled/monotile,
/area/map_template/anomaly/skat_third_deck)
"fB" = (
/obj/forcefield/blocker,
/obj/titan_fluid,
/turf/simulated/floor/plating,
/area/space)
"fM" = (
/turf/simulated/floor/exoplanet/titan_water/maximum{
	density = 1;
	opacity = 1
	},
/area/space)
"fQ" = (
/obj/titan_fluid,
/obj/forcefield/blocker,
/turf/simulated/floor/exoplanet/titan_water/maximum,
/area/space)
"fR" = (
/obj/structure/railing/mapped,
/obj/titan_fluid,
/turf/simulated/floor/tiled/techfloor/grid,
/area/map_template/anomaly/skat_third_deck)
"gh" = (
/obj/titan_fluid,
/turf/simulated/floor/tiled/monotile,
/area/map_template/anomaly/skat_third_deck)
"ht" = (
/obj/floor_decal/industrial/warning/dust{
	dir = 8
	},
/obj/titan_fluid,
/turf/simulated/floor/tiled/techfloor/grid,
/area/map_template/anomaly/skat_third_deck)
"hL" = (
/obj/floor_decal/industrial/warning/dust{
	dir = 4
	},
/obj/structure/railing/mapped{
	dir = 4
	},
/obj/titan_fluid,
/turf/simulated/floor/tiled/monotile,
/area/map_template/anomaly/skat_third_deck)
"iQ" = (
/turf/simulated/floor/plating,
/area/map_template/anomaly/skat_third_deck)
"jh" = (
/obj/titan_fluid,
/obj/landmark/titan_crate/rare_crate,
/turf/simulated/floor/plating,
/area/map_template/anomaly/skat_third_deck)
"jm" = (
/obj/floor_decal/industrial/warning/dust{
	dir = 4
	},
/obj/titan_fluid,
/turf/simulated/floor/tiled/techfloor/grid,
/area/map_template/anomaly/skat_third_deck)
"ka" = (
/obj/titan_fluid,
/obj/floor_decal/stairs{
	dir = 4
	},
/obj/landmark/teleport_to_z_level/skat_third_deck/exit,
/turf/simulated/floor/tiled/monotile,
/area/map_template/anomaly/skat_third_deck)
"ln" = (
/obj/structure/water_drown_structures/paper,
/obj/titan_fluid,
/turf/simulated/floor/exoplanet/titan_water/maximum,
/area/map_template/anomaly/skat_third_deck)
"lw" = (
/obj/titan_fluid,
/turf/simulated/wall/r_wall/prepainted,
/area/map_template/anomaly/skat_third_deck)
"mP" = (
/obj/landmark/titan_crate/rare_crate,
/obj/titan_fluid,
/turf/simulated/floor/plating,
/area/map_template/anomaly/skat_third_deck)
"nB" = (
/obj/floor_decal/industrial/warning,
/obj/titan_fluid,
/obj/structure/railing/mapped,
/turf/simulated/floor/tiled/monotile,
/area/map_template/anomaly/skat_third_deck)
"oK" = (
/obj/forcefield/blocker,
/turf/simulated/floor/exoplanet/titan_water/maximum{
	density = 1;
	opacity = 1;
	name = "edge of world"
	},
/area/space)
"oX" = (
/obj/structure/railing/mapped{
	dir = 4
	},
/obj/floor_decal/industrial/warning/dust{
	dir = 4
	},
/obj/titan_fluid,
/turf/simulated/floor/tiled/monotile,
/area/map_template/anomaly/skat_third_deck)
"pF" = (
/obj/machinery/atmospherics/unary/tank/phoron,
/obj/titan_fluid,
/turf/simulated/floor/tiled/techfloor/grid,
/area/map_template/anomaly/skat_third_deck)
"pY" = (
/obj/titan_fluid,
/obj/structure/railing/mapped{
	dir = 1
	},
/obj/structure/girder,
/turf/simulated/floor/tiled/monotile,
/area/map_template/anomaly/skat_third_deck)
"qc" = (
/obj/structure/water_drown_structures/wooden_planks,
/obj/titan_fluid,
/obj/landmark/titan_crate/weak_crate,
/turf/simulated/floor/tiled/techfloor/grid,
/area/map_template/anomaly/skat_third_deck)
"qK" = (
/obj/structure/water_drown_structures/paper,
/obj/titan_fluid,
/obj/structure/girder,
/turf/simulated/floor/tiled/techfloor/grid,
/area/map_template/anomaly/skat_third_deck)
"rs" = (
/obj/titan_fluid,
/obj/structure/railing/mapped{
	dir = 8
	},
/turf/simulated/floor/tiled/monotile,
/area/map_template/anomaly/skat_third_deck)
"rt" = (
/obj/floor_decal/industrial/warning,
/obj/titan_fluid,
/turf/simulated/floor/tiled/monotile,
/area/map_template/anomaly/skat_third_deck)
"rR" = (
/turf/simulated/floor/exoplanet/titan_water/maximum,
/area/space)
"sL" = (
/obj/forcefield/blocker,
/turf/simulated/floor/exoplanet/titan_water/maximum{
	density = 1;
	opacity = 1
	},
/area/space)
"tb" = (
/obj/titan_fluid,
/obj/forcefield/blocker,
/turf/simulated/floor/tiled/techfloor/grid,
/area/map_template/anomaly/skat_third_deck)
"tA" = (
/obj/titan_fluid,
/obj/titan_fluid,
/turf/simulated/floor/exoplanet/titan_water/maximum{
	density = 1;
	opacity = 1;
	name = "edge of world"
	},
/area/space)
"uf" = (
/turf/simulated/floor/exoplanet/titan_water/maximum{
	density = 1;
	opacity = 1;
	name = "edge of world"
	},
/area/space)
"vd" = (
/obj/floor_decal/industrial/warning/dust{
	dir = 8
	},
/obj/structure/railing/mapped{
	dir = 8
	},
/obj/titan_fluid,
/turf/simulated/floor/tiled/monotile,
/area/map_template/anomaly/skat_third_deck)
"vf" = (
/obj/titan_fluid,
/obj/structure/reagent_dispensers/watertank,
/turf/simulated/floor/tiled/techfloor/grid,
/area/map_template/anomaly/skat_third_deck)
"vy" = (
/obj/floor_decal/industrial/warning{
	dir = 10
	},
/obj/structure/railing/mapped,
/obj/titan_fluid,
/turf/simulated/floor/tiled/monotile,
/area/map_template/anomaly/skat_third_deck)
"vE" = (
/obj/structure/water_drown_structures/wooden_planks,
/obj/titan_fluid,
/turf/simulated/floor/tiled/monotile,
/area/map_template/anomaly/skat_third_deck)
"vK" = (
/obj/structure/water_drown_structures/wooden_planks,
/obj/titan_fluid,
/turf/simulated/floor/tiled/techfloor/grid,
/area/map_template/anomaly/skat_third_deck)
"vX" = (
/obj/titan_fluid,
/turf/simulated/wall/r_wall/hull,
/area/map_template/anomaly/skat_third_deck)
"wk" = (
/obj/floor_decal/industrial/warning{
	dir = 4
	},
/obj/titan_fluid,
/turf/simulated/floor/tiled/techfloor/grid,
/area/map_template/anomaly/skat_third_deck)
"wD" = (
/obj/titan_fluid,
/obj/floor_decal/stairs{
	dir = 4
	},
/turf/simulated/floor/tiled/monotile,
/area/map_template/anomaly/skat_third_deck)
"wJ" = (
/obj/titan_fluid,
/obj/structure/girder,
/turf/simulated/floor/tiled/techfloor/grid,
/area/map_template/anomaly/skat_third_deck)
"wS" = (
/obj/structure/railing/mapped,
/obj/titan_fluid,
/turf/simulated/floor/plating,
/area/map_template/anomaly/skat_third_deck)
"wT" = (
/obj/structure/rubble/house,
/obj/titan_fluid,
/obj/structure/reagent_dispensers/fueltank,
/turf/simulated/floor/tiled/techfloor/grid,
/area/map_template/anomaly/skat_third_deck)
"ya" = (
/obj/forcefield/blocker,
/obj/titan_fluid,
/turf/simulated/floor/exoplanet/titan_water/maximum,
/area/space)
"zd" = (
/obj/titan_fluid,
/obj/structure/railing/mapped{
	dir = 1
	},
/turf/simulated/floor/tiled/monotile,
/area/map_template/anomaly/skat_third_deck)
"AV" = (
/obj/titan_fluid,
/turf/simulated/wall/prepainted,
/area/map_template/anomaly/skat_third_deck)
"Bd" = (
/obj/titan_fluid,
/turf/simulated/floor/exoplanet/titan_water/maximum{
	density = 1;
	opacity = 1
	},
/area/space)
"BH" = (
/obj/structure/water_drown_structures/wooden_planks,
/obj/titan_fluid,
/turf/simulated/floor/plating,
/area/map_template/anomaly/skat_third_deck)
"Ch" = (
/obj/forcefield/blocker,
/obj/titan_fluid,
/obj/titan_fluid,
/turf/simulated/floor/exoplanet/titan_water/maximum,
/area/space)
"Ck" = (
/obj/structure/water_drown_structures/paper,
/obj/floor_decal/industrial/warning{
	dir = 1
	},
/obj/titan_fluid,
/turf/simulated/floor/tiled/monotile,
/area/map_template/anomaly/skat_third_deck)
"Dz" = (
/obj/titan_fluid,
/obj/structure/girder,
/obj/structure/girder,
/turf/simulated/floor/tiled/techfloor/grid,
/area/map_template/anomaly/skat_third_deck)
"Eg" = (
/obj/floor_decal/industrial/warning/dust{
	dir = 4
	},
/obj/structure/water_drown_structures/paper,
/obj/structure/railing/mapped{
	dir = 4
	},
/obj/titan_fluid,
/turf/simulated/floor/tiled/monotile,
/area/map_template/anomaly/skat_third_deck)
"ED" = (
/obj/titan_fluid,
/obj/structure/reagent_dispensers/fueltank,
/turf/simulated/floor/tiled/techfloor/grid,
/area/map_template/anomaly/skat_third_deck)
"Fl" = (
/obj/titan_fluid,
/turf/simulated/floor/plating,
/area/map_template/anomaly/skat_third_deck)
"Fu" = (
/obj/floor_decal/industrial/warning{
	dir = 8
	},
/obj/structure/railing/mapped{
	dir = 8
	},
/obj/titan_fluid,
/turf/simulated/floor/tiled/monotile,
/area/map_template/anomaly/skat_third_deck)
"FB" = (
/obj/titan_fluid,
/obj/forcefield/blocker,
/obj/landmark/titan_crate/rare_crate,
/turf/simulated/floor/plating,
/area/space)
"FQ" = (
/obj/floor_decal/industrial/warning{
	dir = 1
	},
/obj/titan_fluid,
/turf/simulated/floor/exoplanet/titan_water/maximum,
/area/map_template/anomaly/skat_third_deck)
"Gg" = (
/obj/titan_fluid,
/obj/titan_fluid,
/turf/simulated/wall/r_wall/prepainted,
/area/map_template/anomaly/skat_third_deck)
"Gt" = (
/obj/titan_fluid,
/obj/structure/railing/mapped,
/turf/simulated/floor/tiled/techfloor/grid,
/area/map_template/anomaly/skat_third_deck)
"GU" = (
/obj/structure/water_drown_structures/wooden_planks,
/obj/structure/railing/mapped,
/obj/titan_fluid,
/turf/simulated/floor/exoplanet/titan_water/maximum,
/area/map_template/anomaly/skat_third_deck)
"GV" = (
/obj/forcefield/blocker,
/obj/titan_fluid,
/turf/simulated/floor/exoplanet/titan_water/maximum,
/area/map_template/anomaly/skat_third_deck)
"GZ" = (
/obj/titan_fluid,
/obj/titan_fluid,
/obj/mob_spawner/titan_crabs,
/turf/simulated/floor/exoplanet/titan_water/maximum,
/area/map_template/anomaly/skat_third_deck)
"HM" = (
/obj/titan_fluid,
/turf/simulated/floor/exoplanet/titan_water/maximum,
/area/map_template/anomaly/skat_third_deck)
"HP" = (
/obj/floor_decal/industrial/warning,
/obj/structure/railing/mapped,
/obj/titan_fluid,
/turf/simulated/floor/exoplanet/titan_water/maximum,
/area/map_template/anomaly/skat_third_deck)
"Ka" = (
/obj/titan_fluid,
/obj/forcefield/blocker,
/turf/simulated/floor/plating,
/area/space)
"Lf" = (
/obj/landmark/titan_crate/rare_crate,
/obj/titan_fluid,
/turf/simulated/floor/plating,
/area/space)
"LE" = (
/obj/titan_fluid,
/obj/structure/water_drown_structures/paper,
/turf/simulated/floor/tiled/monotile,
/area/map_template/anomaly/skat_third_deck)
"ME" = (
/obj/floor_decal/industrial/warning{
	dir = 4
	},
/obj/titan_fluid,
/obj/titan_fluid,
/turf/simulated/floor/tiled/techfloor/grid,
/area/map_template/anomaly/skat_third_deck)
"MH" = (
/turf/simulated/wall/r_wall/hull,
/area/map_template/anomaly/skat_third_deck)
"Nr" = (
/obj/titan_fluid,
/obj/structure/railing/mapped{
	dir = 4
	},
/turf/simulated/floor/exoplanet/titan_water/maximum,
/area/map_template/anomaly/skat_third_deck)
"NF" = (
/obj/forcefield/blocker,
/obj/titan_fluid,
/turf/simulated/floor/exoplanet/titan_water/maximum{
	density = 1;
	opacity = 1
	},
/area/space)
"OG" = (
/obj/titan_fluid,
/obj/titan_fluid,
/turf/simulated/floor/exoplanet/titan_water/maximum,
/area/map_template/anomaly/skat_third_deck)
"OM" = (
/obj/structure/girder,
/obj/titan_fluid,
/turf/simulated/floor/plating,
/area/map_template/anomaly/skat_third_deck)
"ON" = (
/obj/titan_fluid,
/turf/simulated/floor/exoplanet/titan_water/maximum,
/area/space)
"Pj" = (
/obj/machinery/atmospherics/unary/tank/hydrogen,
/obj/titan_fluid,
/turf/simulated/floor/tiled/techfloor/grid,
/area/map_template/anomaly/skat_third_deck)
"Qm" = (
/obj/titan_fluid,
/obj/forcefield/blocker,
/turf/simulated/floor/exoplanet/titan_water/maximum{
	density = 1;
	opacity = 1;
	name = "edge of world"
	},
/area/space)
"Qr" = (
/obj/forcefield/blocker,
/obj/titan_fluid,
/turf/simulated/floor/exoplanet/titan_water/maximum{
	density = 1;
	opacity = 1;
	name = "edge of world"
	},
/area/space)
"QH" = (
/obj/structure/water_drown_structures/wooden_crates_damaged,
/obj/titan_fluid,
/turf/simulated/floor/exoplanet/titan_water/maximum,
/area/map_template/anomaly/skat_third_deck)
"QK" = (
/obj/titan_fluid,
/obj/structure/girder,
/turf/simulated/floor/tiled/monotile,
/area/map_template/anomaly/skat_third_deck)
"Si" = (
/obj/floor_decal/industrial/warning,
/obj/structure/railing/mapped,
/obj/titan_fluid,
/turf/simulated/floor/tiled/monotile,
/area/map_template/anomaly/skat_third_deck)
"Sz" = (
/obj/floor_decal/industrial/warning,
/obj/structure/railing/mapped,
/obj/titan_fluid,
/obj/structure/girder,
/turf/simulated/floor/tiled/monotile,
/area/map_template/anomaly/skat_third_deck)
"SS" = (
/obj/floor_decal/industrial/warning{
	dir = 9
	},
/obj/structure/railing/mapped{
	dir = 8
	},
/obj/titan_fluid,
/turf/simulated/floor/tiled/monotile,
/area/map_template/anomaly/skat_third_deck)
"Tw" = (
/obj/titan_fluid,
/turf/simulated/floor/exoplanet/titan_water/maximum{
	density = 1;
	opacity = 1;
	name = "edge of world"
	},
/area/space)
"Uc" = (
/obj/forcefield/blocker,
/turf/simulated/floor/exoplanet/titan_water/maximum,
/area/space)
"Uy" = (
/obj/structure/railing/mapped,
/obj/titan_fluid,
/turf/simulated/floor/exoplanet/titan_water/maximum,
/area/map_template/anomaly/skat_third_deck)
"UC" = (
/obj/floor_decal/industrial/warning{
	dir = 8
	},
/obj/titan_fluid,
/turf/simulated/floor/tiled/monotile,
/area/map_template/anomaly/skat_third_deck)
"UG" = (
/obj/titan_fluid,
/obj/structure/railing/mapped{
	dir = 8
	},
/obj/floor_decal/industrial/warning/dust{
	dir = 8
	},
/turf/simulated/floor/tiled/monotile,
/area/map_template/anomaly/skat_third_deck)
"UH" = (
/obj/structure/water_drown_structures/paper,
/obj/titan_fluid,
/obj/landmark/titan_crate/weak_crate,
/turf/simulated/floor/tiled/techfloor/grid,
/area/map_template/anomaly/skat_third_deck)
"Wy" = (
/obj/titan_fluid,
/obj/structure/railing/mapped,
/turf/simulated/floor/tiled/monotile,
/area/map_template/anomaly/skat_third_deck)
"Xe" = (
/obj/structure/water_drown_structures/paper,
/obj/titan_fluid,
/turf/simulated/floor/tiled/monotile,
/area/map_template/anomaly/skat_third_deck)
"Xh" = (
/obj/structure/destroyed_apc,
/obj/titan_fluid,
/turf/simulated/floor/exoplanet/titan_water/maximum,
/area/map_template/anomaly/skat_third_deck)
"Xo" = (
/obj/structure/railing/mapped{
	dir = 8
	},
/obj/floor_decal/industrial/warning/dust{
	dir = 8
	},
/obj/titan_fluid,
/turf/simulated/floor/tiled/monotile,
/area/map_template/anomaly/skat_third_deck)
"XQ" = (
/obj/structure/destroyed_apc,
/obj/floor_decal/industrial/warning/dust{
	dir = 4
	},
/obj/titan_fluid,
/turf/simulated/floor/tiled/techfloor/grid,
/area/map_template/anomaly/skat_third_deck)
"YL" = (
/turf/simulated/floor/exoplanet/titan_water/maximum,
/area/map_template/anomaly/skat_third_deck)
"Zp" = (
/obj/floor_decal/industrial/warning/dust{
	dir = 4
	},
/obj/structure/railing/mapped{
	dir = 4
	},
/obj/titan_fluid,
/turf/simulated/floor/exoplanet/titan_water/maximum,
/area/map_template/anomaly/skat_third_deck)

(1,1,1) = {"
uf
uf
Tw
Tw
Tw
Tw
Tw
Tw
Tw
Tw
Tw
Tw
Tw
Tw
Tw
Tw
Tw
Tw
Tw
Tw
Tw
Tw
Tw
Tw
Tw
Tw
Tw
Tw
Tw
Tw
Tw
Tw
Tw
Tw
Tw
Tw
Tw
Tw
Tw
Tw
"}
(2,1,1) = {"
uf
fM
ON
ON
ON
ON
ON
ON
ON
ON
ON
ON
ON
ON
ON
ON
ON
ON
ON
ON
ON
ON
ON
ON
ON
ON
ON
ON
ON
ON
ON
ak
ON
ON
ON
ON
ak
ak
ak
Tw
"}
(3,1,1) = {"
uf
fM
ON
ON
ON
ON
Tw
Tw
Tw
Tw
Tw
Qm
Qm
Qm
Qm
Qm
Qm
Qm
Qm
Qm
Qm
Qm
Qm
Qm
Qm
Qm
fQ
fQ
fQ
ak
ak
ak
Tw
Tw
ON
ON
ak
ak
ak
Tw
"}
(4,1,1) = {"
uf
fM
ON
ON
ON
ON
ON
ON
ON
ON
ON
fQ
MH
lw
aO
aO
aO
aO
aO
aO
aO
aO
aO
aO
aO
aO
HM
HM
Ka
ak
ak
ak
ak
ak
ON
ON
ON
ak
ak
Tw
"}
(5,1,1) = {"
uf
fM
ON
ON
ON
ON
ON
ON
ON
ON
fQ
fQ
MH
lw
aO
aO
aO
aO
aO
aO
aO
aO
aO
aO
aO
aO
HM
mP
Ka
FB
ak
ak
ak
ak
ak
ON
ON
ON
ak
Tw
"}
(6,1,1) = {"
uf
fM
rR
rR
rR
rR
rR
rR
rR
rR
Uc
MH
MH
lw
aO
aO
aO
aO
aO
aO
aO
aO
aO
aO
aO
aO
HM
mP
mP
fB
Lf
ON
ON
Tw
ON
ON
ON
ON
Tw
Tw
"}
(7,1,1) = {"
uf
fM
rR
rR
rR
rR
rR
rR
rR
rR
Uc
MH
MH
lw
HM
HM
HM
HM
HM
HM
HM
HM
HM
HM
em
em
HM
HM
HM
ya
ON
ON
ON
Tw
ON
ON
ON
ON
Tw
Tw
"}
(8,1,1) = {"
uf
fM
rR
rR
rR
rR
rR
rR
rR
Uc
Uc
MH
MH
lw
QH
HM
HM
HM
HM
HM
HM
HM
HM
QH
em
em
HM
HM
vX
ya
ya
ON
ON
Tw
ON
ON
ON
ON
Tw
Tw
"}
(9,1,1) = {"
Tw
Bd
ON
ON
ON
ON
ON
ON
ON
ya
vX
MH
MH
lw
HM
HM
HM
QH
HM
HM
QH
HM
HM
HM
em
em
HM
HM
vX
vX
ya
ON
ON
Tw
ON
ON
ON
ON
Tw
Tw
"}
(10,1,1) = {"
Tw
Bd
ON
ON
ON
ON
ON
ON
ya
ya
vX
MH
MH
lw
HM
HM
HM
HM
HM
HM
HM
HM
HM
HM
em
em
HM
HM
vX
MH
ya
ya
ON
Tw
ON
ON
ON
ON
Tw
Tw
"}
(11,1,1) = {"
Tw
Bd
ON
ON
ON
ON
ON
ON
ya
vX
vX
MH
MH
lw
HM
HM
HM
HM
HM
HM
HM
QH
HM
HM
QH
HM
HM
HM
vX
MH
vX
ya
ON
Tw
ON
ON
ON
ON
Tw
Tw
"}
(12,1,1) = {"
Tw
Bd
ON
ON
ON
ON
ON
ON
ya
vX
vX
MH
MH
HM
HM
QH
em
HM
HM
HM
HM
HM
HM
HM
HM
HM
HM
HM
vX
MH
vX
ya
ON
Tw
ON
ON
ON
ON
Tw
Tw
"}
(13,1,1) = {"
Tw
Bd
ON
ON
ON
ON
ON
ON
ya
vX
vX
MH
MH
HM
HM
HM
HM
HM
cE
HM
HM
QH
HM
HM
HM
HM
HM
HM
MH
MH
vX
ya
ON
Tw
ON
ON
ON
ON
Tw
Tw
"}
(14,1,1) = {"
Tw
Bd
ON
ON
ON
ON
ON
ya
ya
vX
vX
lw
Fl
Fl
HM
HM
Fl
Fl
HM
Fl
em
HM
HM
HM
HM
HM
HM
HM
lw
MH
vX
ya
ya
Tw
ON
ON
ON
ON
Tw
Tw
"}
(15,1,1) = {"
Tw
Bd
ON
ON
ON
ON
ON
ya
vX
vX
vX
lw
Fl
HM
HM
cE
HM
QH
HM
Fl
Fl
Fl
jh
HM
QH
HM
HM
HM
lw
MH
vX
vX
ya
Tw
ON
ON
ON
ON
Tw
Tw
"}
(16,1,1) = {"
Tw
Bd
ON
ON
ON
ON
ON
ya
vX
vX
vX
HM
HM
QH
HM
HM
HM
HM
HM
Fl
Fl
BH
BH
Fl
HM
HM
HM
HM
lw
MH
vX
vX
ya
Tw
ON
ON
ON
ON
Tw
Tw
"}
(17,1,1) = {"
Tw
Bd
ON
ON
ON
ON
ON
ya
vX
HM
HM
dg
HM
HM
HM
HM
HM
HM
cE
HM
Fl
Fl
jh
Fl
jh
HM
HM
QH
lw
MH
vX
vX
ya
Tw
ON
ON
ON
ON
Tw
Tw
"}
(18,1,1) = {"
Tw
Bd
ON
ON
ON
ON
ON
ya
HM
OM
HM
HM
HM
HM
QH
HM
HM
HM
HM
HM
QH
Fl
Fl
Fl
Fl
HM
HM
HM
lw
MH
vX
vX
ya
Tw
ON
ON
ON
ON
Tw
Tw
"}
(19,1,1) = {"
Tw
Bd
ON
ON
ON
ON
ON
ya
HM
HM
HM
HM
HM
Fl
HM
HM
QH
HM
HM
HM
HM
HM
HM
em
HM
cE
HM
HM
lw
MH
vX
vX
ya
Tw
ON
ON
ON
ON
Tw
Tw
"}
(20,1,1) = {"
Tw
Bd
ON
ON
ON
ON
ON
ya
OM
HM
OM
HM
cE
Fl
HM
HM
HM
HM
HM
cE
HM
HM
cE
cE
HM
HM
HM
HM
lw
MH
vX
vX
ya
Tw
ON
ON
ON
ON
Tw
Tw
"}
(21,1,1) = {"
Tw
Bd
ON
ON
ON
ON
ON
ya
HM
HM
HM
HM
HM
Fl
em
HM
cE
HM
HM
HM
HM
HM
cE
HM
HM
HM
HM
HM
lw
MH
MH
MH
Uc
uf
rR
rR
rR
rR
uf
uf
"}
(22,1,1) = {"
Tw
Bd
ON
ON
ON
ON
ON
ya
HM
HM
vX
lw
HM
HM
QH
HM
HM
HM
QH
HM
HM
HM
HM
HM
HM
HM
QH
HM
lw
MH
MH
MH
Uc
uf
rR
rR
rR
rR
uf
uf
"}
(23,1,1) = {"
Tw
Bd
ON
ON
ON
ON
ya
ya
HM
vX
vX
lw
HM
HM
HM
HM
HM
HM
HM
HM
HM
HM
HM
HM
HM
HM
HM
HM
lw
MH
MH
MH
Uc
oK
rR
rR
rR
rR
uf
uf
"}
(24,1,1) = {"
Tw
Bd
ON
ON
ON
ON
ya
OM
HM
vX
MH
lw
HM
HM
cE
HM
HM
QH
HM
HM
cE
HM
cE
HM
cE
HM
HM
HM
lw
MH
MH
MH
MH
Qm
ON
ON
ON
ON
Tw
Tw
"}
(25,1,1) = {"
Tw
Bd
ON
ON
ON
ON
ya
HM
vX
vX
MH
lw
HM
HM
HM
HM
HM
HM
HM
HM
HM
HM
HM
HM
HM
HM
HM
HM
lw
MH
MH
MH
MH
Qm
ON
ON
ON
ON
Tw
Tw
"}
(26,1,1) = {"
Tw
Bd
ON
ON
ON
ON
ya
vX
vX
vX
MH
lw
QH
Fl
Fl
QH
HM
HM
cE
HM
HM
HM
HM
QH
QH
HM
HM
QH
lw
MH
MH
MH
MH
Qm
ON
ON
ON
ON
Tw
Tw
"}
(27,1,1) = {"
Tw
Bd
ON
ON
ON
ON
ya
HM
vX
vX
MH
lw
HM
HM
Fl
HM
HM
HM
HM
HM
HM
QH
HM
HM
HM
HM
HM
HM
lw
MH
MH
MH
MH
Qm
ON
ON
ON
ON
Tw
Tw
"}
(28,1,1) = {"
Tw
Bd
ON
ON
ON
ON
ya
HM
vX
vX
MH
lw
HM
HM
HM
QH
HM
HM
HM
QH
HM
HM
HM
HM
HM
QH
HM
HM
lw
MH
MH
MH
MH
Qm
ON
ON
ON
ON
Tw
Tw
"}
(29,1,1) = {"
Tw
Bd
ON
ON
ON
ON
ya
HM
HM
vX
MH
lw
aO
aO
aO
aO
aO
aO
aO
aO
aO
aO
aO
aO
aO
aO
aO
aO
lw
MH
MH
MH
MH
Qm
ON
ON
ON
ON
Tw
Tw
"}
(30,1,1) = {"
Tw
Bd
ON
ON
ON
ON
ya
HM
HM
Gg
lw
lw
aO
aO
aO
aO
aO
aO
aO
aO
aO
aO
aO
aO
aO
aO
aO
aO
lw
lw
lw
MH
MH
Qm
ON
ON
ON
ON
Tw
Tw
"}
(31,1,1) = {"
Tw
Bd
ON
ON
ON
ON
ya
HM
HM
OG
gh
gh
Fu
Fu
vy
aY
aY
aY
aY
aY
aY
wJ
wJ
aY
fR
SS
Fu
Fu
gh
gh
lw
MH
MH
Qm
ON
ON
ON
ON
Tw
Tw
"}
(32,1,1) = {"
Tw
Bd
ON
ON
ON
ON
ya
HM
HM
GZ
Nr
dX
dX
dX
Si
vK
aY
aY
aY
aY
wJ
wJ
aY
aY
fR
cm
bU
bU
bU
dX
lw
MH
MH
Qm
ON
ON
ON
ON
Tw
Tw
"}
(33,1,1) = {"
Tw
Bd
ON
ON
ON
ON
ya
HM
HM
OG
HM
HM
aY
aY
Si
aY
aY
aY
aY
aY
wJ
wJ
aY
aY
fR
cm
aY
aY
as
aY
lw
MH
MH
Qm
Tw
ON
ON
ON
Tw
Tw
"}
(34,1,1) = {"
Tw
Bd
ON
ON
ON
ON
ya
HM
HM
OG
HM
HM
HM
aY
Si
aY
aY
qK
wJ
wJ
Dz
aY
aY
aY
fR
Ck
aY
ED
ED
aY
lw
MH
HM
fQ
Tw
ON
ON
ON
Tw
Tw
"}
(35,1,1) = {"
Tw
Bd
ON
ON
ON
ON
ya
HM
HM
OG
HM
HM
HM
aY
Si
qc
ei
en
ei
ei
wJ
ei
ei
ei
fR
cm
aY
wT
wT
aY
lw
HM
OM
fQ
Tw
Tw
Tw
ON
Tw
Tw
"}
(36,1,1) = {"
Tw
Bd
ON
ON
ON
ON
ya
HM
vX
Gg
HM
aY
HM
HM
aY
ei
ei
ei
ei
ei
wJ
ei
en
ei
aY
aY
aY
wT
wT
aY
Fl
OM
HM
fQ
ON
ON
Tw
ON
Tw
Tw
"}
(37,1,1) = {"
Tw
Bd
ON
ON
ON
ON
ya
vX
vX
Gg
aY
vf
aY
HM
HM
ei
ei
ei
ei
ei
wJ
ei
ei
ei
aY
aY
aY
wT
wT
aY
Fl
HM
OM
fQ
ON
Tw
Tw
ON
Tw
Tw
"}
(38,1,1) = {"
Tw
Bd
ON
ON
ON
ON
ya
vX
vX
Gg
aY
vf
vf
HM
HM
HM
HM
aY
aY
aY
wJ
ei
en
ei
aY
aY
aY
wT
wT
aY
Fl
OM
HM
fQ
ON
Tw
ON
ON
Tw
Tw
"}
(39,1,1) = {"
Tw
Bd
ON
ON
ON
ON
ya
vX
vX
Gg
aY
vf
vf
aY
HM
HM
HM
aY
aY
aY
aY
ei
ei
ei
as
aY
aY
ED
ED
aY
lw
MH
HM
fQ
ON
Tw
ON
ON
Tw
Tw
"}
(40,1,1) = {"
Tw
Bd
ON
ON
ON
ON
ya
vX
vX
Gg
aY
vf
vf
aY
aY
aY
aY
aY
as
aY
aY
ei
ei
ei
fR
cm
aY
ED
ED
aY
lw
MH
MH
Qm
ON
ON
ON
ON
Tw
Tw
"}
(41,1,1) = {"
Tw
Bd
ON
ON
ON
ON
ya
vX
vX
Gg
aY
vf
vf
aY
nB
aY
aY
aY
aY
ei
ei
wJ
aY
aY
Gt
cm
aY
ED
ED
aY
lw
MH
MH
Qm
ON
ON
ON
ON
Tw
Tw
"}
(42,1,1) = {"
Tw
Bd
ON
ON
ON
ON
ya
vX
vX
Gg
aY
aY
aY
aY
nB
ei
ei
ei
aY
ei
ei
aY
aY
aY
Gt
FQ
aY
aY
aY
aY
lw
MH
MH
fQ
ON
ON
ON
ON
Tw
Tw
"}
(43,1,1) = {"
Tw
Bd
ON
ON
ON
ON
ya
vX
vX
Gg
rs
rs
rs
rs
Si
ei
en
ei
aY
ei
ei
aY
aY
aY
Uy
FQ
UG
UG
UG
rs
lw
MH
MH
fQ
ON
ON
ON
ON
Tw
Tw
"}
(44,1,1) = {"
Tw
Bd
ON
ON
ON
ON
ya
vX
vX
Gg
oX
oX
oX
oX
Si
ei
ei
ei
aY
qc
ei
aY
wJ
HM
GU
FQ
hL
hL
hL
hL
lw
MH
MH
fQ
ON
ON
ON
ON
Tw
Tw
"}
(45,1,1) = {"
Tw
Bd
ON
ON
ON
ON
ya
vX
vX
Gg
jm
jm
jm
XQ
jm
ei
ei
ei
aY
aY
aY
wJ
HM
HM
HM
aY
aY
aY
aY
aY
lw
MH
MH
fQ
ON
ON
ON
ON
Tw
Tw
"}
(46,1,1) = {"
Tw
Bd
ON
ON
ON
ON
ya
vX
vX
Gg
tb
tb
tb
tb
aY
ei
ei
ei
aY
aY
wJ
em
HM
HM
HM
aY
Pj
Pj
Pj
aY
lw
MH
MH
fQ
ON
ON
ON
ON
Tw
Tw
"}
(47,1,1) = {"
Tw
Bd
ON
ON
ON
ON
ya
vX
vX
Gg
tb
tb
tb
tb
aY
aY
aY
as
aY
aY
HM
HM
HM
HM
HM
aY
Pj
Pj
Pj
aY
lw
MH
MH
fQ
ON
ON
ON
ON
Tw
Tw
"}
(48,1,1) = {"
Tw
Bd
ON
ON
ON
ON
ya
vX
vX
Gg
ht
ht
ht
ht
ht
aY
vK
aY
aY
aY
aY
wJ
aY
ln
aY
aY
Pj
Pj
Pj
aY
lw
MH
MH
fQ
ON
ON
ON
ON
Tw
Tw
"}
(49,1,1) = {"
Tw
Bd
ON
ON
ON
ON
ya
vX
vX
Gg
Xo
Xo
Xo
Xo
Si
aY
ei
ei
ei
HM
HM
aY
HM
HM
HM
aY
Pj
Pj
Pj
aY
lw
MH
MH
fQ
ON
ON
ON
ON
Tw
Tw
"}
(50,1,1) = {"
Tw
Bd
ON
ON
ON
ya
ya
vX
vX
Gg
oX
oX
oX
oX
Si
aY
en
ei
ei
HM
HM
HM
HM
HM
HM
aY
Pj
Pj
Pj
aY
lw
MH
MH
fQ
fQ
ON
ON
ON
Tw
Tw
"}
(51,1,1) = {"
Tw
Bd
ON
ON
ON
ya
vX
vX
vX
Gg
jm
jm
jm
XQ
jm
aY
ei
ei
ei
aY
HM
HM
HM
HM
HM
aY
aY
aY
aY
aY
lw
MH
MH
MH
ya
ON
ON
ON
Tw
Tw
"}
(52,1,1) = {"
uf
fM
rR
rR
rR
Uc
MH
MH
MH
lw
tb
tb
tb
tb
aY
aY
qc
en
UH
aY
aY
aY
aY
aY
fR
cm
vd
vd
vd
vd
lw
MH
MH
MH
ya
ON
ON
ON
Tw
Tw
"}
(53,1,1) = {"
uf
fM
rR
rR
rR
Uc
MH
MH
MH
lw
tb
tb
tb
tb
aY
aY
ei
ei
ei
aY
aY
aY
as
wJ
fR
cm
hL
Eg
hL
hL
lw
vX
vX
vX
ya
ON
ON
ON
Tw
Tw
"}
(54,1,1) = {"
uf
fM
rR
rR
rR
Uc
MH
MH
MH
lw
ht
ht
ht
ht
ht
aY
en
ei
en
aY
aY
aY
aY
aY
aY
aY
aY
aY
aY
aY
lw
vX
vX
HM
ya
ON
ON
ON
ON
Tw
"}
(55,1,1) = {"
uf
fM
rR
rR
rR
Uc
MH
MH
MH
lw
Xo
Xo
Xo
Xo
Si
aY
HM
aY
aY
aY
ei
ei
ei
aY
aY
aY
pF
pF
pF
aY
lw
vX
vX
HM
ya
ON
ON
ON
Tw
Tw
"}
(56,1,1) = {"
uf
fM
Uc
Uc
Uc
Uc
MH
MH
MH
lw
hL
hL
hL
Zp
HP
HM
HM
aY
aY
aY
qc
en
ei
aY
aY
aY
pF
pF
pF
aY
lw
vX
vX
HM
ya
ya
ya
ya
Tw
Tw
"}
(57,1,1) = {"
uf
fM
Uc
MH
MH
MH
MH
MH
MH
lw
jm
jm
jm
Xh
HM
HM
aY
aY
aY
aY
ei
ei
ei
aY
aY
aY
pF
pF
pF
aY
lw
vX
vX
OM
HM
HM
HM
GV
Tw
Tw
"}
(58,1,1) = {"
uf
sL
Uc
MH
MH
MH
MH
MH
MH
lw
tb
tb
tb
tb
aY
HM
HM
HM
vK
aY
ei
ei
ei
aY
aY
aY
pF
pF
pF
aY
lw
vX
vX
HM
HM
HM
HM
GV
ya
Tw
"}
(59,1,1) = {"
uf
sL
MH
MH
MH
MH
MH
MH
MH
lw
tb
tb
cw
cw
ln
HM
aY
aY
aY
aY
en
ei
ei
aY
aY
aY
pF
pF
pF
aY
lw
vX
HM
HM
HM
HM
HM
HM
ya
Tw
"}
(60,1,1) = {"
oK
sL
MH
MH
YL
YL
MH
MH
MH
lw
ht
ht
HM
HM
HM
HM
aY
HM
HM
aY
ei
ei
UH
aY
aY
aY
aY
aY
aY
aY
lw
vX
HM
HM
HM
HM
HM
HM
ya
Qr
"}
(61,1,1) = {"
oK
MH
MH
MH
YL
YL
MH
MH
MH
lw
vd
HM
HM
HM
Si
aY
HM
HM
em
aY
aY
aY
aY
aY
fR
cm
vd
vd
vd
vd
lw
HM
HM
HM
HM
HM
HM
HM
HM
Qr
"}
(62,1,1) = {"
oK
MH
MH
YL
YL
YL
MH
MH
MH
lw
gh
HM
vE
gh
Si
HM
HM
HM
ln
aY
aY
aY
aY
aY
fR
cm
gh
gh
gh
gh
HM
OM
HM
HM
HM
HM
HM
HM
HM
Qr
"}
(63,1,1) = {"
oK
MH
MH
YL
YL
YL
MH
MH
MH
lw
AV
AV
QK
AV
HM
HM
HM
HM
HM
aY
vK
aY
aY
aY
aY
AV
AV
gh
AV
HM
HM
HM
HM
HM
HM
HM
HM
HM
HM
Qr
"}
(64,1,1) = {"
oK
MH
MH
YL
YL
YL
MH
MH
MH
lw
LE
gh
gh
gh
HM
HM
aY
wk
wk
ME
wk
wk
wk
aY
aY
AV
gh
gh
HM
HM
HM
HM
HM
HM
HM
HM
HM
HM
HM
Qr
"}
(65,1,1) = {"
oK
MH
MH
YL
YL
YL
MH
MH
MH
lw
QK
gh
QK
HM
HM
HM
AV
Fl
Fl
Fl
Fl
BH
Fl
AV
AV
AV
gh
gh
HM
HM
HM
HM
HM
HM
HM
HM
HM
HM
HM
Qr
"}
(66,1,1) = {"
oK
MH
MH
YL
YL
YL
MH
MH
MH
lw
gh
dX
dX
gh
gh
gh
Si
Fl
Fl
Fl
iQ
Fl
wS
cm
gh
gh
gh
HM
HM
HM
Fl
HM
OM
HM
HM
HM
HM
HM
HM
Qr
"}
(67,1,1) = {"
oK
MH
MH
YL
YL
YL
MH
MH
MH
lw
Wy
ka
wD
pY
gh
gh
fl
Fl
Fl
Fl
Fl
Fl
Fl
cm
gh
gh
gh
HM
HM
HM
HM
HM
HM
HM
HM
HM
HM
HM
HM
Qr
"}
(68,1,1) = {"
oK
MH
MH
YL
YL
YL
MH
MH
MH
lw
Wy
QK
gh
zd
QK
gh
rt
Fl
Fl
Fl
Fl
Fl
Fl
cm
gh
gh
HM
HM
HM
HM
HM
OM
HM
HM
HM
HM
HM
HM
HM
Qr
"}
(69,1,1) = {"
oK
MH
MH
YL
YL
YL
MH
MH
MH
lw
QK
gh
gh
gh
Xe
gh
Sz
Fl
Fl
Fl
Fl
Fl
wS
cm
gh
gh
HM
em
HM
HM
HM
HM
HM
OM
HM
HM
HM
HM
HM
Qr
"}
(70,1,1) = {"
oK
MH
MH
YL
YL
YL
MH
MH
MH
lw
gh
gh
QK
gh
gh
gh
gh
Fu
Fu
UC
UC
Fu
Fu
gh
gh
HM
HM
HM
HM
HM
HM
HM
vX
vX
HM
HM
HM
HM
HM
Qr
"}
(71,1,1) = {"
oK
MH
MH
MH
MH
MH
MH
MH
MH
lw
gh
gh
gh
gh
gh
gh
QK
gh
gh
gh
gh
gh
cB
cB
cB
OG
OG
OG
OG
OG
OG
bQ
vX
vX
HM
HM
HM
HM
HM
Qr
"}
(72,1,1) = {"
oK
sL
MH
Uc
Uc
Uc
MH
MH
MH
lw
lw
lw
lw
lw
lw
lw
lw
lw
lw
lw
lw
lw
Gg
Gg
Gg
OG
OG
OG
OG
Gg
Gg
bQ
vX
vX
ya
ya
ya
HM
ya
Qr
"}
(73,1,1) = {"
uf
sL
Uc
Uc
rR
Uc
Uc
MH
MH
MH
MH
MH
MH
MH
MH
MH
MH
MH
MH
vX
vX
vX
bQ
vX
HM
HM
HM
HM
HM
vX
vX
bQ
vX
ya
ya
ON
ya
ya
NF
Tw
"}
(74,1,1) = {"
uf
fM
rR
rR
rR
rR
Uc
Uc
Uc
Uc
Uc
Uc
Uc
Uc
Uc
Uc
Uc
Uc
Uc
ya
ya
ya
Ch
ya
ya
ya
ya
ya
ya
ya
ya
Ch
ya
ya
ON
ON
ON
ON
Bd
Tw
"}
(75,1,1) = {"
uf
uf
uf
uf
uf
uf
uf
uf
uf
uf
uf
uf
uf
uf
uf
uf
uf
uf
uf
Tw
Tw
Tw
tA
ON
Tw
ON
ON
ON
Tw
Tw
Tw
tA
Tw
Tw
Tw
Tw
Tw
ON
Tw
Tw
"}
