//MAP CONVERTED BY dmm2tgm.py THIS HEADER COMMENT PREVENTS RECONVERSION, DO NOT REMOVE
"ak" = (
/obj/titan_fluid,
/obj/forcefield/blocker,
/turf/simulated/floor/exoplanet/titan_water/middle{
	density = 1
	},
/area/space)
"as" = (
/obj/structure/water_drown_structures/paper,
/obj/titan_fluid,
/turf/simulated/floor/tiled/techfloor/grid,
/area/map_template/anomaly/skat_second_deck)
"aO" = (
/obj/machinery/door/blast/regular{
	id_tag = "colblast"
	},
/obj/titan_fluid,
/turf/simulated/floor/tiled/techfloor/grid,
/area/map_template/anomaly/skat_second_deck)
"aY" = (
/obj/titan_fluid,
/turf/simulated/floor/tiled/techfloor/grid,
/area/map_template/anomaly/skat_second_deck)
"bQ" = (
/obj/floor_decal/industrial/warning,
/obj/structure/railing/mapped,
/obj/titan_fluid,
/obj/landmark/titan_crate,
/turf/simulated/floor/tiled/monotile,
/area/map_template/anomaly/skat_second_deck)
"bU" = (
/obj/titan_fluid,
/obj/landmark/titan_crate,
/turf/simulated/floor/tiled/monotile,
/area/map_template/anomaly/skat_second_deck)
"cm" = (
/obj/floor_decal/industrial/warning{
	dir = 1
	},
/obj/titan_fluid,
/turf/simulated/floor/tiled/monotile,
/area/map_template/anomaly/skat_second_deck)
"cw" = (
/obj/structure/reagent_dispensers/fueltank,
/obj/titan_fluid,
/turf/simulated/floor/tiled/monotile,
/area/map_template/anomaly/skat_second_deck)
"cE" = (
/obj/structure/rubble/house,
/obj/random/trash,
/obj/random/trash,
/obj/random/trash,
/obj/titan_fluid,
/turf/simulated/floor/tiled/monotile,
/area/map_template/anomaly/skat_second_deck)
"dX" = (
/obj/structure/railing/mapped,
/obj/titan_fluid,
/turf/simulated/floor/tiled/monotile,
/area/map_template/anomaly/skat_second_deck)
"ei" = (
/obj/titan_fluid,
/obj/landmark/titan_crate,
/turf/simulated/floor/tiled/techfloor/grid,
/area/map_template/anomaly/skat_second_deck)
"em" = (
/obj/landmark/teleport_to_z_level/skat/exit,
/obj/titan_fluid,
/turf/simulated/floor/tiled/monotile,
/area/map_template/anomaly/skat_second_deck)
"en" = (
/obj/titan_fluid,
/obj/landmark/titan_crate,
/obj/landmark/titan_crate,
/turf/simulated/floor/tiled/techfloor/grid,
/area/map_template/anomaly/skat_second_deck)
"fl" = (
/obj/floor_decal/industrial/warning/dust{
	dir = 8
	},
/obj/titan_fluid,
/obj/landmark/titan_crate,
/turf/simulated/floor/tiled/techfloor/grid,
/area/map_template/anomaly/skat_second_deck)
"fM" = (
/turf/simulated/floor/exoplanet/titan_water/maximum{
	density = 1;
	opacity = 1
	},
/area/space)
"fQ" = (
/obj/titan_fluid,
/obj/forcefield/blocker,
/turf/simulated/floor/exoplanet/titan_water/maximum,
/area/space)
"fR" = (
/obj/structure/railing/mapped,
/obj/titan_fluid,
/turf/simulated/floor/tiled/techfloor/grid,
/area/map_template/anomaly/skat_second_deck)
"gh" = (
/obj/titan_fluid,
/turf/simulated/floor/tiled/monotile,
/area/map_template/anomaly/skat_second_deck)
"ht" = (
/obj/floor_decal/industrial/warning/dust{
	dir = 8
	},
/obj/titan_fluid,
/turf/simulated/floor/tiled/techfloor/grid,
/area/map_template/anomaly/skat_second_deck)
"hL" = (
/obj/floor_decal/industrial/warning/dust{
	dir = 4
	},
/obj/structure/railing/mapped{
	dir = 4
	},
/obj/titan_fluid,
/turf/simulated/floor/tiled/monotile,
/area/map_template/anomaly/skat_second_deck)
"iQ" = (
/obj/titan_fluid,
/turf/simulated/floor/exoplanet/titan_water/middle,
/area/map_template/anomaly/skat_second_deck)
"jh" = (
/obj/structure/water_drown_structures,
/obj/titan_fluid,
/turf/simulated/floor/tiled/techfloor/grid,
/area/map_template/anomaly/skat_second_deck)
"jm" = (
/obj/floor_decal/industrial/warning/dust{
	dir = 4
	},
/obj/titan_fluid,
/turf/simulated/floor/tiled/techfloor/grid,
/area/map_template/anomaly/skat_second_deck)
"ka" = (
/obj/structure/water_drown_structures/paper,
/obj/structure/reagent_dispensers/watertank,
/obj/titan_fluid,
/turf/simulated/floor/tiled/monotile,
/area/map_template/anomaly/skat_second_deck)
"ln" = (
/obj/structure/water_drown_structures/paper,
/obj/titan_fluid,
/obj/landmark/titan_crate,
/turf/simulated/floor/tiled/techfloor/grid,
/area/map_template/anomaly/skat_second_deck)
"lw" = (
/obj/titan_fluid,
/turf/simulated/wall/r_wall/prepainted,
/area/map_template/anomaly/skat_second_deck)
"mP" = (
/obj/structure/water_drown_structures/paper,
/obj/structure/railing/mapped,
/obj/titan_fluid,
/turf/simulated/floor/tiled/techfloor/grid,
/area/map_template/anomaly/skat_second_deck)
"nB" = (
/obj/structure/railing/mapped{
	dir = 8
	},
/obj/titan_fluid,
/turf/simulated/floor/tiled/monotile,
/area/map_template/anomaly/skat_second_deck)
"oK" = (
/obj/forcefield/blocker,
/turf/simulated/floor/exoplanet/titan_water/maximum{
	density = 1;
	opacity = 1;
	name = "edge of world"
	},
/area/space)
"oX" = (
/obj/structure/railing/mapped{
	dir = 4
	},
/obj/floor_decal/industrial/warning/dust{
	dir = 4
	},
/obj/titan_fluid,
/turf/simulated/floor/tiled/monotile,
/area/map_template/anomaly/skat_second_deck)
"pF" = (
/obj/machinery/atmospherics/unary/tank/phoron,
/obj/titan_fluid,
/turf/simulated/floor/tiled/techfloor/grid,
/area/map_template/anomaly/skat_second_deck)
"qc" = (
/obj/structure/water_drown_structures/wooden_planks,
/obj/titan_fluid,
/obj/landmark/titan_crate,
/turf/simulated/floor/tiled/techfloor/grid,
/area/map_template/anomaly/skat_second_deck)
"rs" = (
/obj/titan_fluid,
/turf/simulated/floor/exoplanet/titan_water/middle{
	density = 1
	},
/area/space)
"rt" = (
/obj/floor_decal/industrial/warning,
/obj/titan_fluid,
/turf/simulated/floor/tiled/monotile,
/area/map_template/anomaly/skat_second_deck)
"rR" = (
/turf/simulated/floor/exoplanet/titan_water/maximum,
/area/space)
"sL" = (
/obj/forcefield/blocker,
/turf/simulated/floor/exoplanet/titan_water/maximum{
	density = 1;
	opacity = 1
	},
/area/space)
"tb" = (
/obj/titan_fluid,
/obj/forcefield/blocker,
/turf/simulated/floor/tiled/techfloor/grid,
/area/map_template/anomaly/skat_second_deck)
"uf" = (
/turf/simulated/floor/exoplanet/titan_water/maximum{
	density = 1;
	opacity = 1;
	name = "edge of world"
	},
/area/space)
"vd" = (
/obj/floor_decal/industrial/warning/dust{
	dir = 8
	},
/obj/structure/railing/mapped{
	dir = 8
	},
/obj/titan_fluid,
/turf/simulated/floor/tiled/monotile,
/area/map_template/anomaly/skat_second_deck)
"vf" = (
/obj/structure/water_drown_structures,
/obj/titan_fluid,
/turf/simulated/floor/exoplanet/titan_water/maximum,
/area/map_template/anomaly/skat_second_deck)
"vy" = (
/obj/floor_decal/industrial/warning{
	dir = 10
	},
/obj/structure/railing/mapped,
/obj/structure/railing/mapped{
	dir = 8
	},
/obj/titan_fluid,
/turf/simulated/floor/tiled/monotile,
/area/map_template/anomaly/skat_second_deck)
"vE" = (
/obj/structure/water_drown_structures/wooden_planks,
/obj/titan_fluid,
/turf/simulated/floor/tiled/monotile,
/area/map_template/anomaly/skat_second_deck)
"vK" = (
/obj/structure/water_drown_structures/wooden_planks,
/obj/titan_fluid,
/turf/simulated/floor/tiled/techfloor/grid,
/area/map_template/anomaly/skat_second_deck)
"wk" = (
/obj/floor_decal/industrial/warning{
	dir = 4
	},
/obj/titan_fluid,
/turf/simulated/floor/tiled/techfloor/grid,
/area/map_template/anomaly/skat_second_deck)
"wD" = (
/obj/floor_decal/industrial/warning{
	dir = 1
	},
/obj/titan_fluid,
/obj/random/biggun,
/turf/simulated/floor/tiled/monotile,
/area/map_template/anomaly/skat_second_deck)
"wJ" = (
/obj/structure/water_drown_structures,
/obj/floor_decal/industrial/warning,
/obj/titan_fluid,
/turf/simulated/floor/tiled/monotile,
/area/map_template/anomaly/skat_second_deck)
"wS" = (
/obj/structure/railing/mapped,
/obj/titan_fluid,
/turf/simulated/floor/exoplanet/titan_water/middle,
/area/map_template/anomaly/skat_second_deck)
"wT" = (
/obj/structure/rubble/house,
/obj/random/trash,
/obj/titan_fluid,
/turf/simulated/floor/tiled/monotile,
/area/map_template/anomaly/skat_second_deck)
"AV" = (
/obj/titan_fluid,
/turf/simulated/wall/prepainted,
/area/map_template/anomaly/skat_second_deck)
"Ck" = (
/obj/structure/water_drown_structures/paper,
/obj/floor_decal/industrial/warning{
	dir = 1
	},
/obj/titan_fluid,
/turf/simulated/floor/tiled/monotile,
/area/map_template/anomaly/skat_second_deck)
"Eg" = (
/obj/floor_decal/industrial/warning/dust{
	dir = 4
	},
/obj/structure/water_drown_structures/paper,
/obj/structure/railing/mapped{
	dir = 4
	},
/obj/titan_fluid,
/turf/simulated/floor/tiled/monotile,
/area/map_template/anomaly/skat_second_deck)
"ED" = (
/obj/structure/railing/mapped{
	dir = 4
	},
/obj/floor_decal/industrial/warning/dust{
	dir = 4
	},
/obj/titan_fluid,
/obj/landmark/titan_crate,
/turf/simulated/floor/tiled/monotile,
/area/map_template/anomaly/skat_second_deck)
"Fl" = (
/obj/titan_fluid,
/turf/simulated/floor/plating,
/area/map_template/anomaly/skat_second_deck)
"Fu" = (
/obj/floor_decal/industrial/warning{
	dir = 8
	},
/obj/structure/railing/mapped{
	dir = 8
	},
/obj/titan_fluid,
/turf/simulated/floor/tiled/monotile,
/area/map_template/anomaly/skat_second_deck)
"FQ" = (
/obj/floor_decal/industrial/warning/dust{
	dir = 8
	},
/obj/structure/railing/mapped{
	dir = 8
	},
/obj/titan_fluid,
/obj/landmark/titan_crate,
/turf/simulated/floor/tiled/monotile,
/area/map_template/anomaly/skat_second_deck)
"Gt" = (
/obj/structure/water_drown_structures/wooden_crates_damaged,
/obj/titan_fluid,
/turf/simulated/floor/tiled/techfloor/grid,
/area/map_template/anomaly/skat_second_deck)
"GU" = (
/obj/structure/water_drown_structures/wooden_planks,
/obj/structure/railing/mapped,
/obj/titan_fluid,
/turf/simulated/floor/tiled/techfloor/grid,
/area/map_template/anomaly/skat_second_deck)
"HM" = (
/obj/floor_decal/stairs{
	dir = 1
	},
/obj/titan_fluid,
/turf/simulated/floor/tiled/monotile,
/area/map_template/anomaly/skat_second_deck)
"Ka" = (
/obj/structure/railing/mapped{
	dir = 4
	},
/obj/titan_fluid,
/turf/simulated/floor/tiled/monotile,
/area/map_template/anomaly/skat_second_deck)
"ME" = (
/obj/landmark/teleport_to_z_level/skat_third_deck,
/obj/titan_fluid,
/turf/simulated/floor/exoplanet/titan_water/maximum,
/area/map_template/anomaly/skat_second_deck)
"MH" = (
/turf/simulated/wall/r_wall/hull,
/area/map_template/anomaly/skat_second_deck)
"OM" = (
/obj/structure/girder,
/obj/titan_fluid,
/turf/simulated/floor/exoplanet/titan_water/middle,
/area/map_template/anomaly/skat_second_deck)
"ON" = (
/obj/titan_fluid,
/turf/simulated/floor/exoplanet/titan_water/maximum,
/area/space)
"OQ" = (
/obj/structure/water_drown_structures/wooden_planks,
/obj/titan_fluid,
/turf/simulated/floor/exoplanet/titan_water/middle,
/area/map_template/anomaly/skat_second_deck)
"Pj" = (
/obj/machinery/atmospherics/unary/tank/hydrogen,
/obj/titan_fluid,
/turf/simulated/floor/tiled/techfloor/grid,
/area/map_template/anomaly/skat_second_deck)
"Qm" = (
/obj/titan_fluid,
/obj/forcefield/blocker,
/turf/simulated/floor/exoplanet/titan_water/maximum{
	density = 1;
	opacity = 1;
	name = "edge of world"
	},
/area/space)
"QH" = (
/obj/structure/water_drown_structures/wooden_crates_damaged,
/obj/titan_fluid,
/turf/simulated/floor/exoplanet/titan_water/maximum,
/area/map_template/anomaly/skat_second_deck)
"QK" = (
/obj/structure/reagent_dispensers/watertank,
/obj/titan_fluid,
/turf/simulated/floor/tiled/monotile,
/area/map_template/anomaly/skat_second_deck)
"Si" = (
/obj/floor_decal/industrial/warning,
/obj/structure/railing/mapped,
/obj/titan_fluid,
/turf/simulated/floor/tiled/monotile,
/area/map_template/anomaly/skat_second_deck)
"Sz" = (
/obj/structure/railing/mapped,
/obj/titan_fluid,
/obj/landmark/titan_crate,
/turf/simulated/floor/tiled/techfloor/grid,
/area/map_template/anomaly/skat_second_deck)
"SS" = (
/obj/floor_decal/industrial/warning{
	dir = 9
	},
/obj/structure/railing/mapped{
	dir = 8
	},
/obj/titan_fluid,
/turf/simulated/floor/tiled/monotile,
/area/map_template/anomaly/skat_second_deck)
"Tw" = (
/obj/titan_fluid,
/turf/simulated/floor/exoplanet/titan_water/maximum{
	density = 1;
	opacity = 1;
	name = "edge of world"
	},
/area/space)
"Uc" = (
/obj/forcefield/blocker,
/turf/simulated/floor/exoplanet/titan_water/maximum,
/area/space)
"Uy" = (
/obj/machinery/atmospherics/unary/engine{
	dir = 8
	},
/turf/simulated/wall/r_wall/hull,
/area/map_template/anomaly/skat_second_deck)
"UC" = (
/obj/floor_decal/industrial/warning{
	dir = 8
	},
/obj/titan_fluid,
/turf/simulated/floor/tiled/monotile,
/area/map_template/anomaly/skat_second_deck)
"UG" = (
/obj/floor_decal/industrial/warning/dust{
	dir = 4
	},
/obj/titan_fluid,
/obj/landmark/titan_crate,
/turf/simulated/floor/tiled/techfloor/grid,
/area/map_template/anomaly/skat_second_deck)
"UH" = (
/obj/structure/rubble/house,
/obj/titan_fluid,
/turf/simulated/floor/tiled/monotile,
/area/map_template/anomaly/skat_second_deck)
"Wy" = (
/obj/structure/water_drown_structures,
/obj/titan_fluid,
/turf/simulated/floor/tiled/monotile,
/area/map_template/anomaly/skat_second_deck)
"Xe" = (
/obj/structure/water_drown_structures/paper,
/obj/titan_fluid,
/turf/simulated/floor/tiled/monotile,
/area/map_template/anomaly/skat_second_deck)
"Xo" = (
/obj/structure/railing/mapped{
	dir = 8
	},
/obj/floor_decal/industrial/warning/dust{
	dir = 8
	},
/obj/titan_fluid,
/turf/simulated/floor/tiled/monotile,
/area/map_template/anomaly/skat_second_deck)
"XQ" = (
/obj/structure/destroyed_apc,
/obj/floor_decal/industrial/warning/dust{
	dir = 4
	},
/obj/titan_fluid,
/turf/simulated/floor/tiled/techfloor/grid,
/area/map_template/anomaly/skat_second_deck)
"YL" = (
/turf/simulated/floor/exoplanet/titan_water/maximum,
/area/map_template/anomaly/skat_second_deck)
"Zp" = (
/obj/floor_decal/industrial/warning{
	dir = 1
	},
/obj/titan_fluid,
/obj/landmark/titan_crate,
/turf/simulated/floor/tiled/monotile,
/area/map_template/anomaly/skat_second_deck)

(1,1,1) = {"
uf
uf
Tw
Tw
Tw
Tw
Tw
Tw
Tw
Tw
Tw
Tw
Tw
Tw
Tw
Tw
Tw
Tw
Tw
Tw
Tw
Tw
Tw
Tw
Tw
Tw
Tw
Tw
Tw
Tw
Tw
Tw
Tw
Tw
Tw
Tw
Tw
Tw
Tw
Tw
"}
(2,1,1) = {"
uf
fM
ON
ON
ON
ON
ON
ON
ON
ON
ON
ON
ON
ON
ON
ON
ON
ON
ON
ON
ON
ON
ON
ON
ON
ON
ON
ON
ON
ON
ON
ON
ON
ON
ON
ON
ON
ON
Tw
Tw
"}
(3,1,1) = {"
uf
fM
ON
ON
ON
ON
Tw
Tw
Tw
Tw
Tw
Qm
Qm
Qm
Qm
Qm
Qm
Qm
Qm
Qm
Qm
Qm
Qm
Qm
Qm
Qm
Qm
Qm
Qm
Tw
Tw
Tw
Tw
Tw
ON
ON
ON
ON
Tw
Tw
"}
(4,1,1) = {"
uf
fM
ON
ON
ON
ON
ON
ON
ON
ON
ON
fQ
MH
lw
aO
aO
aO
aO
aO
aO
aO
aO
aO
aO
aO
aO
lw
MH
fQ
ON
ON
ON
ON
Tw
ON
ON
ON
ON
Tw
Tw
"}
(5,1,1) = {"
uf
fM
ON
ON
ON
ON
ON
ON
ON
ON
fQ
fQ
MH
lw
aO
aO
aO
aO
aO
aO
aO
aO
aO
aO
aO
aO
lw
MH
fQ
fQ
ON
ON
ON
Tw
ON
ON
ON
ON
Tw
Tw
"}
(6,1,1) = {"
uf
fM
rR
rR
rR
rR
rR
rR
rR
rR
Uc
MH
MH
lw
aO
aO
aO
aO
aO
aO
aO
aO
aO
aO
aO
aO
lw
MH
MH
Uc
rR
rR
rR
uf
rR
rR
rR
rR
uf
uf
"}
(7,1,1) = {"
uf
fM
rR
rR
rR
rR
rR
rR
rR
rR
Uc
MH
MH
lw
aY
aY
aY
aY
aY
aY
aY
aY
aY
aY
aY
aY
lw
MH
MH
Uc
rR
rR
rR
uf
rR
rR
rR
rR
uf
uf
"}
(8,1,1) = {"
uf
fM
rR
rR
rR
rR
rR
rR
rR
Uc
Uc
MH
MH
lw
Gt
aY
aY
aY
aY
aY
aY
aY
aY
Gt
aY
aY
lw
MH
MH
Uc
Uc
rR
rR
uf
rR
rR
rR
rR
uf
uf
"}
(9,1,1) = {"
uf
fM
rR
rR
rR
rR
rR
rR
rR
Uc
MH
MH
MH
lw
aY
aY
aY
Gt
aY
aY
Gt
aY
aY
aY
aY
aY
lw
MH
MH
MH
Uc
rR
rR
uf
rR
rR
rR
rR
uf
uf
"}
(10,1,1) = {"
uf
fM
rR
rR
rR
rR
rR
rR
Uc
Uc
MH
MH
MH
lw
aY
aY
aY
aY
aY
aY
aY
aY
aY
aY
aY
aY
lw
MH
MH
MH
Uc
Uc
rR
uf
rR
rR
rR
rR
uf
uf
"}
(11,1,1) = {"
uf
fM
rR
rR
rR
rR
rR
rR
Uc
MH
MH
MH
MH
lw
aY
aY
aY
aY
aY
aY
aY
Gt
aY
aY
Gt
aY
lw
MH
MH
MH
MH
Uc
rR
uf
rR
rR
rR
rR
uf
uf
"}
(12,1,1) = {"
uf
fM
rR
rR
rR
rR
rR
rR
Uc
MH
MH
MH
MH
lw
aY
Gt
aY
aY
aY
aY
aY
aY
aY
aY
aY
aY
lw
MH
MH
MH
MH
Uc
rR
uf
rR
rR
rR
rR
uf
uf
"}
(13,1,1) = {"
uf
fM
rR
rR
rR
rR
rR
rR
Uc
MH
MH
MH
MH
lw
aY
aY
aY
aY
vK
aY
aY
Gt
aY
aY
aY
aY
lw
MH
MH
MH
MH
Uc
rR
uf
rR
rR
rR
rR
uf
uf
"}
(14,1,1) = {"
uf
fM
rR
rR
rR
rR
rR
Uc
Uc
MH
MH
lw
lw
lw
aY
aY
aY
aY
aY
aY
aY
aY
aY
aY
aY
aY
lw
lw
lw
MH
MH
Uc
Uc
uf
rR
rR
rR
rR
uf
uf
"}
(15,1,1) = {"
uf
fM
rR
rR
rR
rR
rR
Uc
MH
MH
MH
lw
aY
aY
aY
vK
aY
Gt
aY
aY
aY
aY
aY
aY
Gt
aY
aY
aY
lw
MH
MH
MH
Uc
uf
rR
rR
rR
rR
uf
uf
"}
(16,1,1) = {"
uf
fM
rR
rR
rR
rR
rR
Uc
MH
MH
MH
lw
aY
Gt
aY
aY
aY
aY
aY
aY
aY
vK
vK
aY
aY
aY
aY
aY
lw
MH
MH
MH
Uc
uf
rR
rR
rR
rR
uf
uf
"}
(17,1,1) = {"
uf
fM
rR
rR
rR
rR
rR
Uc
MH
MH
MH
lw
aY
aY
aY
aY
aY
aY
vK
aY
aY
aY
aY
aY
aY
aY
aY
Gt
lw
MH
MH
MH
Uc
uf
rR
rR
rR
rR
uf
uf
"}
(18,1,1) = {"
uf
fM
rR
rR
rR
rR
rR
Uc
MH
MH
MH
lw
aY
aY
Gt
aY
aY
aY
aY
aY
Gt
aY
aY
aY
aY
aY
aY
aY
lw
MH
MH
MH
Uc
uf
rR
rR
rR
rR
uf
uf
"}
(19,1,1) = {"
uf
fM
rR
rR
rR
rR
rR
Uc
MH
MH
MH
lw
aY
aY
aY
aY
Gt
aY
aY
aY
aY
aY
aY
aY
aY
vK
aY
aY
lw
MH
MH
MH
Uc
uf
rR
rR
rR
rR
uf
uf
"}
(20,1,1) = {"
uf
fM
rR
rR
rR
rR
rR
Uc
MH
MH
MH
lw
vK
aY
aY
aY
aY
aY
aY
vK
aY
aY
vK
vK
aY
aY
aY
aY
lw
MH
MH
MH
Uc
uf
rR
rR
rR
rR
uf
uf
"}
(21,1,1) = {"
uf
fM
rR
rR
rR
rR
rR
Uc
MH
MH
MH
lw
aY
aY
aY
aY
vK
aY
aY
aY
aY
aY
vK
aY
aY
aY
aY
aY
lw
MH
MH
MH
Uc
uf
rR
rR
rR
rR
uf
uf
"}
(22,1,1) = {"
uf
fM
rR
rR
rR
rR
rR
Uc
MH
MH
MH
lw
aY
aY
Gt
aY
aY
aY
Gt
aY
aY
aY
aY
aY
aY
aY
Gt
aY
lw
MH
MH
MH
Uc
uf
rR
rR
rR
rR
uf
uf
"}
(23,1,1) = {"
uf
fM
rR
rR
rR
rR
Uc
Uc
MH
MH
MH
lw
aY
aY
aY
aY
aY
aY
aY
aY
aY
aY
aY
aY
aY
aY
aY
aY
lw
MH
MH
MH
Uc
oK
rR
rR
rR
rR
uf
uf
"}
(24,1,1) = {"
uf
fM
rR
rR
rR
rR
Uc
MH
MH
MH
MH
lw
aY
aY
vK
aY
aY
Gt
aY
aY
vK
aY
vK
aY
vK
aY
aY
aY
lw
MH
MH
MH
MH
Qm
ON
ON
ON
ON
Tw
Tw
"}
(25,1,1) = {"
uf
fM
rR
rR
rR
rR
Uc
MH
MH
MH
MH
lw
aY
aY
aY
aY
aY
aY
aY
aY
aY
aY
aY
aY
aY
aY
aY
aY
lw
MH
MH
MH
MH
Qm
ON
ON
ON
ON
Tw
Tw
"}
(26,1,1) = {"
uf
fM
rR
rR
rR
rR
Uc
MH
MH
MH
MH
lw
Gt
aY
aY
Gt
aY
aY
vK
aY
aY
aY
aY
Gt
Gt
aY
aY
Gt
lw
MH
MH
MH
MH
Qm
ON
ON
ON
ON
Tw
Tw
"}
(27,1,1) = {"
uf
fM
rR
rR
rR
rR
Uc
MH
MH
MH
MH
lw
aY
aY
aY
aY
aY
aY
aY
aY
aY
Gt
aY
aY
aY
aY
aY
aY
lw
MH
MH
MH
MH
Qm
ON
ON
ON
ON
Tw
Tw
"}
(28,1,1) = {"
uf
fM
rR
rR
rR
rR
Uc
MH
MH
MH
MH
lw
aY
aY
aY
Gt
aY
aY
aY
Gt
aY
aY
aY
aY
aY
Gt
aY
aY
lw
MH
MH
MH
MH
Qm
ON
ON
ON
ON
Tw
Tw
"}
(29,1,1) = {"
uf
fM
rR
rR
rR
rR
Uc
MH
MH
MH
MH
lw
aO
aO
aO
aO
aO
aO
aO
aO
aO
aO
aO
aO
aO
aO
aO
aO
lw
MH
MH
MH
MH
Qm
ON
ON
ON
ON
Tw
Tw
"}
(30,1,1) = {"
uf
fM
rR
rR
rR
rR
Uc
MH
MH
lw
lw
lw
aO
aO
aO
aO
aO
aO
aO
aO
aO
aO
aO
aO
aO
aO
aO
aO
lw
lw
lw
MH
MH
Qm
ON
ON
ON
ON
Tw
Tw
"}
(31,1,1) = {"
uf
fM
rR
rR
rR
rR
Uc
MH
MH
lw
gh
gh
Fu
Fu
vy
aY
aY
aY
aY
aY
aY
aY
aY
aY
fR
SS
Fu
Fu
gh
gh
lw
MH
MH
Qm
ON
ON
ON
ON
Tw
Tw
"}
(32,1,1) = {"
uf
fM
rR
rR
rR
rR
Uc
MH
MH
lw
gh
gh
gh
gh
Si
vK
ei
aY
aY
aY
aY
aY
aY
aY
fR
cm
gh
gh
gh
gh
lw
MH
MH
Qm
ON
ON
ON
ON
Tw
Tw
"}
(33,1,1) = {"
uf
fM
rR
rR
rR
rR
Uc
MH
MH
lw
gh
gh
gh
gh
Si
aY
ei
ei
ei
aY
aY
aY
aY
aY
fR
cm
gh
gh
Xe
gh
lw
MH
MH
Qm
Tw
ON
ON
ON
Tw
Tw
"}
(34,1,1) = {"
uf
fM
rR
rR
rR
rR
Uc
MH
MH
lw
gh
gh
gh
gh
Si
aY
aY
as
ei
ei
aY
aY
aY
ei
fR
Ck
gh
gh
gh
gh
lw
MH
iQ
Qm
Tw
ON
ON
ON
Tw
Tw
"}
(35,1,1) = {"
uf
fM
rR
rR
rR
rR
Uc
MH
MH
lw
Wy
Ka
Ka
gh
Si
vK
aY
aY
ei
aY
aY
aY
ei
ei
Sz
cm
gh
wT
cE
gh
lw
iQ
OM
ak
Tw
Tw
Tw
ON
Tw
Tw
"}
(36,1,1) = {"
uf
fM
rR
rR
rR
rR
Uc
MH
MH
lw
dX
em
HM
gh
rt
aY
aY
ei
aY
ei
aY
aY
aY
aY
ei
Zp
wT
wT
cE
wT
Fl
OM
iQ
ak
rs
rs
Tw
ON
Tw
Tw
"}
(37,1,1) = {"
uf
fM
rR
rR
rR
rR
Uc
MH
MH
lw
dX
gh
HM
gh
wJ
ei
ei
aY
aY
aY
ei
aY
aY
aY
aY
cm
wT
wT
UH
wT
Fl
iQ
OM
ak
rs
Tw
Tw
ON
Tw
Tw
"}
(38,1,1) = {"
uf
fM
rR
rR
rR
rR
Uc
MH
MH
lw
vE
nB
nB
gh
Si
jh
aY
aY
aY
aY
aY
aY
aY
aY
fR
cm
wT
wT
wT
gh
Fl
OM
iQ
ak
rs
Tw
ON
ON
Tw
Tw
"}
(39,1,1) = {"
uf
fM
rR
rR
rR
rR
Uc
MH
MH
lw
gh
gh
gh
gh
Si
aY
aY
aY
aY
ei
aY
aY
aY
ei
mP
cm
gh
gh
gh
gh
lw
MH
iQ
Qm
Tw
Tw
ON
ON
Tw
Tw
"}
(40,1,1) = {"
uf
fM
rR
rR
rR
rR
Uc
MH
MH
lw
gh
gh
gh
gh
Si
aY
aY
aY
as
ei
ei
ei
aY
en
fR
cm
gh
gh
gh
gh
lw
MH
MH
Qm
ON
ON
ON
ON
Tw
Tw
"}
(41,1,1) = {"
uf
fM
rR
rR
rR
rR
Uc
MH
MH
lw
gh
vf
QH
gh
rt
aY
aY
aY
ei
ei
ei
ei
aY
ei
ei
cm
gh
vf
QH
gh
lw
MH
MH
Qm
ON
ON
ON
ON
Tw
Tw
"}
(42,1,1) = {"
uf
fM
rR
rR
rR
rR
Uc
MH
MH
lw
gh
vf
QH
gh
rt
aY
ei
aY
aY
aY
ei
aY
aY
ei
aY
cm
gh
QH
vf
gh
lw
MH
MH
fQ
ON
ON
ON
ON
Tw
Tw
"}
(43,1,1) = {"
uf
fM
rR
rR
rR
rR
Uc
MH
MH
lw
gh
gh
gh
gh
Si
ei
aY
aY
aY
aY
ei
ei
aY
aY
fR
cm
gh
gh
gh
gh
lw
MH
MH
fQ
ON
ON
ON
ON
Tw
Tw
"}
(44,1,1) = {"
uf
fM
rR
rR
rR
rR
Uc
MH
MH
lw
oX
oX
oX
oX
Si
ei
ei
ei
ei
vK
aY
aY
aY
aY
GU
cm
hL
hL
hL
hL
lw
MH
MH
fQ
ON
ON
ON
ON
Tw
Tw
"}
(45,1,1) = {"
uf
fM
rR
rR
rR
rR
Uc
MH
MH
lw
jm
jm
jm
XQ
jm
aY
aY
aY
aY
aY
aY
aY
aY
ei
aY
ei
aY
aY
aY
aY
lw
MH
MH
fQ
ON
ON
ON
ON
Tw
Tw
"}
(46,1,1) = {"
uf
fM
rR
rR
rR
rR
Uc
MH
MH
lw
tb
tb
tb
tb
aY
aY
aY
aY
aY
aY
aY
aY
aY
ei
ei
aY
Pj
Pj
Pj
aY
lw
MH
MH
fQ
ON
ON
ON
ON
Tw
Tw
"}
(47,1,1) = {"
uf
fM
rR
rR
rR
rR
Uc
MH
MH
lw
tb
tb
tb
tb
aY
ei
ei
as
aY
aY
ei
ei
aY
aY
ei
ei
Pj
Pj
Pj
aY
lw
MH
MH
fQ
ON
ON
ON
ON
Tw
Tw
"}
(48,1,1) = {"
uf
fM
rR
rR
rR
rR
Uc
MH
MH
lw
ht
ht
ht
ht
ht
aY
qc
ei
aY
aY
ei
ei
aY
ln
ei
aY
Pj
Pj
Pj
aY
lw
MH
MH
fQ
ON
ON
ON
ON
Tw
Tw
"}
(49,1,1) = {"
uf
fM
rR
rR
rR
rR
Uc
MH
MH
lw
Xo
Xo
Xo
Xo
Si
aY
aY
ei
ei
aY
aY
aY
aY
aY
aY
aY
Pj
Pj
Pj
aY
lw
MH
MH
fQ
ON
ON
ON
ON
Tw
Tw
"}
(50,1,1) = {"
uf
fM
rR
rR
rR
Uc
Uc
MH
MH
lw
oX
oX
oX
ED
bQ
aY
aY
aY
aY
aY
aY
aY
aY
aY
aY
aY
Pj
Pj
Pj
aY
lw
MH
MH
fQ
fQ
ON
ON
ON
Tw
Tw
"}
(51,1,1) = {"
uf
fM
rR
rR
rR
Uc
MH
MH
MH
lw
jm
jm
jm
XQ
UG
ei
aY
aY
aY
aY
aY
ei
aY
aY
aY
aY
aY
aY
aY
aY
lw
MH
MH
MH
Uc
rR
rR
rR
uf
uf
"}
(52,1,1) = {"
uf
fM
rR
rR
rR
Uc
MH
MH
MH
lw
tb
tb
tb
tb
aY
ei
qc
aY
ln
ei
ei
ei
aY
aY
fR
cm
vd
vd
vd
vd
lw
MH
MH
MH
Uc
rR
rR
rR
uf
uf
"}
(53,1,1) = {"
uf
fM
rR
rR
rR
Uc
MH
MH
MH
lw
tb
tb
tb
tb
aY
aY
aY
aY
ei
ei
aY
aY
as
aY
fR
cm
hL
Eg
hL
hL
lw
MH
MH
MH
Uc
rR
rR
rR
uf
uf
"}
(54,1,1) = {"
uf
fM
rR
rR
rR
Uc
MH
MH
MH
lw
ht
ht
ht
ht
ht
aY
aY
aY
aY
aY
aY
aY
aY
aY
ei
aY
aY
aY
aY
aY
lw
MH
MH
MH
Uc
rR
rR
rR
uf
uf
"}
(55,1,1) = {"
uf
fM
rR
rR
rR
Uc
MH
MH
MH
lw
Xo
Xo
Xo
Xo
Si
aY
aY
aY
aY
aY
aY
aY
ei
ei
ei
aY
pF
pF
pF
aY
lw
MH
MH
MH
Uc
rR
rR
rR
uf
uf
"}
(56,1,1) = {"
uf
fM
Uc
Uc
Uc
Uc
MH
MH
MH
lw
hL
hL
hL
hL
Si
aY
aY
aY
aY
aY
qc
ei
ei
ei
ei
ei
pF
pF
pF
aY
lw
MH
MH
MH
Uc
Uc
Uc
Uc
uf
uf
"}
(57,1,1) = {"
uf
fM
Uc
MH
MH
MH
MH
MH
MH
lw
jm
jm
jm
XQ
jm
aY
aY
aY
aY
ei
aY
ei
ei
aY
aY
aY
pF
pF
pF
aY
lw
MH
MH
MH
MH
MH
MH
Uc
uf
uf
"}
(58,1,1) = {"
uf
sL
Uc
MH
MH
MH
MH
MH
MH
lw
tb
tb
tb
tb
aY
aY
aY
aY
vK
aY
aY
aY
aY
aY
aY
aY
pF
pF
pF
aY
lw
MH
MH
MH
MH
MH
MH
Uc
oK
uf
"}
(59,1,1) = {"
uf
sL
MH
MH
MH
MH
MH
MH
MH
lw
tb
tb
tb
tb
as
aY
ei
aY
aY
aY
aY
aY
ei
ei
ei
aY
pF
pF
pF
aY
lw
MH
MH
MH
MH
MH
MH
MH
oK
uf
"}
(60,1,1) = {"
oK
sL
MH
MH
YL
YL
MH
MH
MH
lw
ht
ht
ht
ht
fl
ei
aY
aY
aY
aY
aY
aY
as
aY
ei
ei
ei
ei
aY
aY
lw
MH
MH
MH
YL
YL
MH
MH
oK
oK
"}
(61,1,1) = {"
oK
MH
MH
MH
YL
YL
MH
MH
MH
lw
vd
vd
FQ
FQ
bQ
aY
ei
aY
aY
aY
aY
ei
aY
aY
Sz
wD
vd
vd
vd
vd
lw
MH
MH
MH
YL
YL
MH
MH
MH
oK
"}
(62,1,1) = {"
oK
MH
MH
YL
YL
YL
MH
MH
MH
lw
gh
bU
vE
bU
Si
ei
aY
ei
as
aY
ei
ei
ei
ei
Sz
Zp
bU
gh
gh
gh
lw
MH
MH
MH
YL
YL
YL
MH
MH
oK
"}
(63,1,1) = {"
oK
MH
MH
YL
YL
YL
MH
MH
MH
lw
AV
AV
gh
AV
AV
aY
aY
aY
aY
aY
vK
aY
aY
aY
aY
AV
AV
gh
AV
AV
lw
MH
MH
MH
YL
YL
YL
MH
MH
oK
"}
(64,1,1) = {"
oK
MH
MH
YL
YL
YL
MH
MH
MH
lw
QK
QK
gh
QK
AV
aY
aY
wk
wk
wk
wk
wk
wk
aY
aY
AV
cw
gh
cw
cw
lw
MH
MH
MH
YL
YL
YL
MH
MH
oK
"}
(65,1,1) = {"
oK
MH
MH
YL
YL
YL
MH
MH
MH
lw
QK
QK
gh
QK
AV
AV
AV
iQ
iQ
iQ
iQ
OQ
iQ
AV
AV
AV
cw
gh
cw
cw
lw
MH
MH
MH
YL
YL
YL
MH
MH
oK
"}
(66,1,1) = {"
oK
MH
MH
YL
YL
YL
MH
MH
MH
lw
QK
QK
gh
gh
gh
gh
Si
iQ
iQ
iQ
iQ
iQ
wS
cm
gh
gh
gh
gh
cw
cw
lw
MH
MH
MH
YL
YL
YL
MH
MH
oK
"}
(67,1,1) = {"
oK
MH
MH
YL
YL
YL
MH
MH
MH
lw
QK
ka
gh
QK
QK
QK
rt
iQ
iQ
iQ
ME
iQ
iQ
cm
cw
cw
cw
gh
cw
cw
lw
MH
MH
MH
YL
YL
YL
MH
MH
oK
"}
(68,1,1) = {"
oK
MH
MH
YL
YL
YL
MH
MH
MH
lw
QK
QK
Xe
QK
QK
QK
rt
iQ
iQ
iQ
iQ
iQ
iQ
cm
cw
cw
cw
gh
cw
cw
lw
MH
MH
MH
YL
YL
YL
MH
MH
oK
"}
(69,1,1) = {"
oK
MH
MH
YL
YL
YL
MH
MH
MH
lw
QK
QK
gh
QK
ka
QK
Si
iQ
iQ
iQ
iQ
iQ
wS
cm
cw
cw
cw
gh
cw
cw
lw
MH
MH
MH
YL
YL
YL
MH
MH
oK
"}
(70,1,1) = {"
oK
MH
MH
YL
YL
YL
MH
MH
MH
lw
QK
QK
gh
QK
QK
QK
gh
Fu
Fu
UC
UC
Fu
Fu
gh
cw
cw
cw
gh
cw
cw
lw
MH
MH
MH
YL
YL
YL
MH
MH
oK
"}
(71,1,1) = {"
oK
MH
MH
Uy
Uy
Uy
MH
MH
MH
lw
QK
QK
gh
gh
gh
gh
gh
gh
gh
gh
gh
gh
gh
gh
gh
gh
gh
gh
cw
cw
lw
MH
MH
MH
Uy
Uy
Uy
MH
MH
oK
"}
(72,1,1) = {"
oK
sL
MH
Uc
Uc
Uc
MH
MH
MH
lw
lw
lw
lw
lw
lw
lw
lw
lw
lw
lw
lw
lw
lw
lw
lw
lw
lw
lw
lw
lw
lw
MH
MH
MH
Uc
Uc
Uc
MH
sL
oK
"}
(73,1,1) = {"
uf
sL
Uc
Uc
rR
Uc
Uc
MH
Uy
Uy
Uy
Uy
Uy
Uy
Uy
Uy
Uy
Uy
Uy
Uy
Uy
Uy
Uy
Uy
Uy
Uy
Uy
Uy
Uy
Uy
Uy
Uy
MH
Uc
Uc
rR
Uc
Uc
sL
uf
"}
(74,1,1) = {"
uf
fM
rR
rR
rR
rR
Uc
Uc
Uc
Uc
Uc
Uc
Uc
Uc
Uc
Uc
Uc
Uc
Uc
Uc
Uc
Uc
Uc
Uc
Uc
Uc
Uc
Uc
Uc
Uc
Uc
Uc
Uc
Uc
rR
rR
rR
rR
fM
uf
"}
(75,1,1) = {"
uf
uf
uf
uf
uf
uf
uf
uf
uf
uf
uf
uf
uf
uf
uf
uf
uf
uf
uf
uf
uf
uf
uf
uf
uf
uf
uf
uf
uf
uf
uf
uf
uf
uf
uf
uf
uf
uf
uf
uf
"}
