//MAP CONVERTED BY dmm2tgm.py THIS HEADER COMMENT PREVENTS RECONVERSION, DO NOT REMOVE
"apW" = (
/obj/item/artefact/svetlyak,
/turf/simulated/floor/exoplanet/concrete/reinforced/road,
/area/liberia/atmos)
"cpC" = (
/turf/simulated/floor/exoplanet/concrete/reinforced/road,
/area/centcom)
"cPZ" = (
/obj/item/gun/projectile/automatic,
/turf/simulated/floor/exoplanet/concrete/reinforced/road,
/area/centcom)
"djw" = (
/turf/simulated/floor/exoplanet/titan_water/middle,
/area/centcom)
"dlo" = (
/obj/titan_fluid,
/turf/simulated/floor/exoplanet/concrete/reinforced/road,
/area/centcom)
"dRf" = (
/turf/simulated/floor/exoplanet/concrete/reinforced/road,
/area/liberia/atmos)
"dSB" = (
/turf/simulated/floor/exoplanet/titan_water/minimal,
/area/centcom)
"eDA" = (
/obj/random/biggun,
/turf/simulated/floor/exoplanet/concrete/reinforced/road,
/area/centcom)
"eZS" = (
/obj/item/gun/projectile/automatic/minigun,
/turf/simulated/floor/exoplanet/concrete/reinforced/road,
/area/centcom)
"fkK" = (
/obj/item/gun/energy/sniperrifle,
/turf/simulated/floor/exoplanet/concrete/reinforced/road,
/area/centcom)
"geK" = (
/obj/item/gun/magnetic/railgun/tc,
/turf/simulated/floor/exoplanet/concrete/reinforced/road,
/area/centcom)
"ieF" = (
/obj/structure/closet/coffin/wooden,
/turf/simulated/floor/exoplanet/concrete/reinforced/road,
/area/centcom)
"jjy" = (
/obj/item/artefact/svetlyak,
/turf/simulated/floor/exoplanet/titan_water/middle,
/area/liberia/atmos)
"jDb" = (
/obj/item/gun/projectile/automatic/nt41,
/turf/simulated/floor/exoplanet/concrete/reinforced/road,
/area/centcom)
"kSl" = (
/obj/item/gun/projectile/heavysniper/ant,
/turf/simulated/floor/exoplanet/concrete/reinforced/road,
/area/centcom)
"ldi" = (
/obj/item/gun/projectile/automatic/bullpup_rifle/light,
/turf/simulated/floor/exoplanet/concrete/reinforced/road,
/area/centcom)
"lUp" = (
/obj/item/gun/energy/laser/xenofauna,
/turf/simulated/floor/exoplanet/concrete/reinforced/road,
/area/centcom)
"mJI" = (
/mob/living/carbon/human/dummy,
/turf/simulated/floor/exoplanet/concrete/reinforced/road,
/area/centcom)
"nsq" = (
/obj/item/gun/projectile/automatic/bullpup_rifle,
/turf/simulated/floor/exoplanet/concrete/reinforced/road,
/area/centcom)
"nuF" = (
/obj/item/gun/projectile/automatic/l6_saw,
/turf/simulated/floor/exoplanet/concrete/reinforced/road,
/area/centcom)
"nyu" = (
/obj/item/gun/projectile/automatic/mbr,
/turf/simulated/floor/exoplanet/concrete/reinforced/road,
/area/centcom)
"odH" = (
/turf/simulated/floor/exoplanet/titan_water/middle,
/area/liberia/atmos)
"ooX" = (
/obj/landmark/no_weather_here{
	layer = 2
	},
/turf/unsimulated/floor/grass,
/area/centcom)
"pnX" = (
/turf/simulated/floor/exoplanet/titan_water/maximum,
/area/liberia/atmos)
"pxw" = (
/turf/simulated/floor/exoplanet/titan_water/minimal,
/area/liberia/atmos)
"pSk" = (
/obj/landmark{
	name = "Observer-Start"
	},
/obj/landmark/no_weather_here{
	layer = 2
	},
/obj/landmark{
	name = "JoinLateCryo"
	},
/turf/unsimulated/floor/grass,
/area/centcom)
"qMW" = (
/obj/item/gun/projectile/pistol/m19,
/turf/simulated/floor/exoplanet/concrete/reinforced/road,
/area/centcom)
"qRd" = (
/obj/item/clothing/suit/space/void/security,
/turf/simulated/floor/exoplanet/concrete/reinforced/road,
/area/liberia/atmos)
"reO" = (
/obj/item/gun/projectile/pistol/magnum_pistol,
/turf/simulated/floor/exoplanet/concrete/reinforced/road,
/area/centcom)
"rJb" = (
/obj/item/gun/projectile/automatic/sec_smg,
/turf/simulated/floor/exoplanet/concrete/reinforced/road,
/area/centcom)
"sao" = (
/obj/item/gun/projectile/sniper/semistrip,
/turf/simulated/floor/exoplanet/concrete/reinforced/road,
/area/centcom)
"scc" = (
/obj/landmark/no_weather_here{
	layer = 2
	},
/obj/landmark{
	name = "JoinLateCryo"
	},
/turf/unsimulated/floor/grass,
/area/centcom)
"sJt" = (
/obj/structure/table/steel,
/turf/simulated/floor/exoplanet/concrete/reinforced/road,
/area/centcom)
"uzJ" = (
/turf/unsimulated/wall,
/area/centcom)
"uVd" = (
/obj/item/clothing/suit/space/void/atmos,
/turf/simulated/floor/exoplanet/concrete/reinforced/road,
/area/liberia/atmos)
"vuz" = (
/turf/simulated/floor/exoplanet/titan_water/maximum,
/area/centcom)
"vLC" = (
/obj/item/gun/projectile/automatic/merc_smg,
/turf/simulated/floor/exoplanet/concrete/reinforced/road,
/area/centcom)
"vPX" = (
/obj/item/gun/energy/mindflayer,
/turf/simulated/floor/exoplanet/concrete/reinforced/road,
/area/centcom)
"wVg" = (
/obj/item/gun/energy/laser,
/turf/simulated/floor/exoplanet/concrete/reinforced/road,
/area/centcom)
"xbv" = (
/obj/item/clothing/suit/space/void/merc,
/turf/simulated/floor/exoplanet/concrete/reinforced/road,
/area/liberia/atmos)
"xBf" = (
/obj/item/gun/energy/lasercannon,
/turf/simulated/floor/exoplanet/concrete/reinforced/road,
/area/centcom)

(1,1,1) = {"
uzJ
uzJ
uzJ
uzJ
uzJ
uzJ
uzJ
uzJ
uzJ
uzJ
uzJ
uzJ
uzJ
uzJ
uzJ
uzJ
uzJ
uzJ
uzJ
uzJ
uzJ
uzJ
uzJ
uzJ
"}
(2,1,1) = {"
uzJ
cpC
cpC
cpC
cpC
cpC
apW
dRf
dRf
dRf
apW
cpC
cpC
cpC
cpC
cpC
cpC
cpC
cpC
cpC
cpC
cpC
cpC
uzJ
"}
(3,1,1) = {"
uzJ
cpC
cpC
cpC
cpC
cpC
dRf
pxw
pxw
pxw
uVd
cpC
cpC
cpC
cpC
cpC
cpC
cpC
cpC
cpC
cpC
cpC
cpC
uzJ
"}
(4,1,1) = {"
uzJ
cpC
cpC
cpC
cpC
cpC
dRf
pxw
pxw
pxw
xbv
cpC
cpC
cpC
cpC
cpC
cpC
cpC
cpC
cpC
cpC
cpC
cpC
uzJ
"}
(5,1,1) = {"
uzJ
cpC
cpC
cpC
cpC
cpC
dRf
pxw
pxw
pxw
qRd
dSB
dSB
dSB
dSB
dSB
cpC
cpC
cpC
cpC
cpC
cpC
cpC
uzJ
"}
(6,1,1) = {"
uzJ
cpC
cpC
cpC
cpC
cpC
dRf
odH
odH
odH
dRf
dSB
djw
djw
djw
dSB
cpC
cpC
cpC
cpC
cpC
cpC
cpC
uzJ
"}
(7,1,1) = {"
uzJ
cpC
cpC
cpC
cpC
cpC
dRf
odH
jjy
odH
dRf
dSB
djw
vuz
djw
dSB
cpC
ooX
ooX
ooX
cpC
cpC
cpC
uzJ
"}
(8,1,1) = {"
uzJ
cpC
cpC
cpC
cpC
cpC
dRf
odH
odH
odH
dRf
dSB
djw
djw
djw
dSB
ooX
ooX
scc
ooX
ooX
cpC
cpC
uzJ
"}
(9,1,1) = {"
uzJ
cpC
cpC
cpC
cpC
cpC
dRf
pnX
pnX
pnX
dRf
dSB
dSB
dSB
dSB
dSB
ooX
scc
pSk
scc
ooX
cpC
cpC
uzJ
"}
(10,1,1) = {"
uzJ
cpC
cpC
cpC
cpC
cpC
dRf
pnX
pnX
pnX
dRf
cpC
cpC
cpC
cpC
cpC
ooX
ooX
scc
ooX
ooX
cpC
cpC
uzJ
"}
(11,1,1) = {"
uzJ
cpC
cpC
cpC
cpC
cpC
dRf
pnX
pnX
pnX
dRf
cpC
cpC
cpC
cpC
cpC
cpC
ooX
ooX
ooX
cpC
cpC
cpC
uzJ
"}
(12,1,1) = {"
uzJ
cpC
cpC
cpC
cpC
cpC
apW
dRf
dRf
dRf
apW
cpC
dlo
dlo
dlo
cpC
cpC
cpC
cpC
cpC
cpC
cpC
cpC
uzJ
"}
(13,1,1) = {"
uzJ
cpC
cpC
cpC
cpC
cpC
cpC
cpC
cpC
cpC
cpC
cpC
dlo
dlo
dlo
cpC
uzJ
cpC
cpC
cpC
cpC
ieF
cpC
uzJ
"}
(14,1,1) = {"
uzJ
cpC
cpC
cpC
cpC
cpC
cpC
cpC
cpC
cpC
cpC
cpC
dlo
dlo
dlo
mJI
sJt
cpC
fkK
vPX
xBf
lUp
wVg
uzJ
"}
(15,1,1) = {"
uzJ
cpC
cpC
cpC
cpC
cpC
cpC
cpC
cpC
cpC
cpC
cpC
cpC
cpC
cpC
cpC
uzJ
cpC
cpC
cpC
cpC
cpC
cpC
uzJ
"}
(16,1,1) = {"
uzJ
cpC
cpC
cpC
cpC
cpC
cpC
cpC
cpC
cpC
cpC
cpC
cpC
cpC
mJI
cpC
sJt
cpC
nuF
ldi
nsq
cPZ
geK
uzJ
"}
(17,1,1) = {"
uzJ
cpC
cpC
cpC
cpC
cpC
cpC
cpC
cpC
cpC
cpC
cpC
cpC
mJI
cpC
cpC
sJt
cpC
cpC
cpC
cpC
cpC
cpC
uzJ
"}
(18,1,1) = {"
uzJ
cpC
cpC
cpC
cpC
cpC
cpC
cpC
cpC
cpC
cpC
cpC
cpC
cpC
cpC
cpC
uzJ
cpC
rJb
jDb
eZS
vLC
nyu
uzJ
"}
(19,1,1) = {"
uzJ
cpC
cpC
cpC
cpC
cpC
cpC
cpC
cpC
cpC
cpC
cpC
mJI
cpC
cpC
cpC
sJt
cpC
cpC
cpC
cpC
cpC
cpC
uzJ
"}
(20,1,1) = {"
uzJ
cpC
cpC
cpC
cpC
cpC
cpC
cpC
cpC
cpC
cpC
mJI
cpC
cpC
cpC
cpC
sJt
cpC
eDA
sao
qMW
reO
kSl
uzJ
"}
(21,1,1) = {"
uzJ
cpC
cpC
cpC
cpC
cpC
cpC
cpC
cpC
cpC
cpC
cpC
cpC
cpC
cpC
cpC
uzJ
cpC
cpC
cpC
cpC
cpC
cpC
uzJ
"}
(22,1,1) = {"
uzJ
cpC
cpC
cpC
cpC
cpC
cpC
cpC
cpC
cpC
mJI
cpC
cpC
cpC
cpC
cpC
sJt
cpC
cpC
cpC
cpC
cpC
cpC
uzJ
"}
(23,1,1) = {"
uzJ
cpC
cpC
cpC
cpC
cpC
cpC
cpC
cpC
mJI
cpC
cpC
cpC
cpC
cpC
cpC
sJt
cpC
cpC
cpC
cpC
cpC
cpC
uzJ
"}
(24,1,1) = {"
uzJ
cpC
cpC
cpC
cpC
cpC
cpC
cpC
cpC
cpC
cpC
cpC
cpC
cpC
cpC
cpC
uzJ
cpC
cpC
cpC
cpC
cpC
cpC
uzJ
"}
(25,1,1) = {"
uzJ
cpC
cpC
cpC
cpC
cpC
cpC
cpC
cpC
cpC
cpC
cpC
cpC
cpC
cpC
cpC
cpC
cpC
cpC
cpC
cpC
cpC
cpC
uzJ
"}
(26,1,1) = {"
uzJ
cpC
cpC
cpC
cpC
cpC
cpC
cpC
cpC
cpC
cpC
cpC
cpC
cpC
cpC
cpC
uzJ
cpC
cpC
cpC
cpC
cpC
cpC
uzJ
"}
(27,1,1) = {"
uzJ
uzJ
uzJ
uzJ
uzJ
uzJ
uzJ
uzJ
uzJ
uzJ
uzJ
uzJ
uzJ
uzJ
uzJ
uzJ
uzJ
uzJ
uzJ
uzJ
uzJ
uzJ
uzJ
uzJ
"}
