//MAP CONVERTED BY dmm2tgm.py THIS HEADER COMMENT PREVENTS RECONVERSION, DO NOT REMOVE
"cpC" = (
/turf/simulated/floor/exoplanet/concrete/reinforced/road,
/area/centcom)
"cPZ" = (
/obj/item/gun/projectile/automatic,
/turf/simulated/floor/exoplanet/concrete/reinforced/road,
/area/centcom)
"dre" = (
/obj/landmark/teleport_to_z_level/skat,
/turf/simulated/floor/exoplanet/titan_water/maximum,
/area/centcom)
"dRf" = (
/turf/simulated/mineral/ice,
/area/centcom)
"eDA" = (
/obj/random/biggun,
/turf/simulated/floor/exoplanet/concrete/reinforced/road,
/area/centcom)
"eZS" = (
/obj/item/gun/projectile/automatic/minigun,
/turf/simulated/floor/exoplanet/concrete/reinforced/road,
/area/centcom)
"fkK" = (
/obj/item/gun/energy/sniperrifle,
/turf/simulated/floor/exoplanet/concrete/reinforced/road,
/area/centcom)
"geK" = (
/obj/item/gun/magnetic/railgun/tcc,
/turf/simulated/floor/exoplanet/concrete/reinforced/road,
/area/centcom)
"jjy" = (
/turf/space,
/area/space)
"jDb" = (
/obj/item/gun/projectile/automatic/nt41,
/turf/simulated/floor/exoplanet/concrete/reinforced/road,
/area/centcom)
"kSl" = (
/obj/item/gun/projectile/heavysniper/ant,
/turf/simulated/floor/exoplanet/concrete/reinforced/road,
/area/centcom)
"ldi" = (
/obj/item/gun/projectile/automatic/bullpup_rifle/light,
/turf/simulated/floor/exoplanet/concrete/reinforced/road,
/area/centcom)
"lUp" = (
/obj/item/gun/energy/laser/xenofauna,
/turf/simulated/floor/exoplanet/concrete/reinforced/road,
/area/centcom)
"mJI" = (
/mob/living/carbon/human/dummy,
/turf/simulated/floor/exoplanet/concrete/reinforced/road,
/area/centcom)
"nsq" = (
/obj/item/gun/projectile/automatic/bullpup_rifle,
/turf/simulated/floor/exoplanet/concrete/reinforced/road,
/area/centcom)
"nuF" = (
/obj/item/gun/projectile/automatic/l6_saw,
/turf/simulated/floor/exoplanet/concrete/reinforced/road,
/area/centcom)
"nyu" = (
/obj/item/gun/projectile/automatic/mbr,
/turf/simulated/floor/exoplanet/concrete/reinforced/road,
/area/centcom)
"odH" = (
/turf/simulated/floor/exoplanet/titan_water/middle,
/area/centcom)
"ooX" = (
/obj/landmark/no_weather_here{
	layer = 2
	},
/turf/unsimulated/floor/grass,
/area/centcom)
"pnX" = (
/turf/simulated/floor/exoplanet/titan_water/maximum,
/area/centcom)
"pxw" = (
/turf/simulated/floor/exoplanet/titan_water/minimal,
/area/centcom)
"pSk" = (
/obj/landmark{
	name = "Observer-Start"
	},
/obj/landmark/no_weather_here{
	layer = 2
	},
/obj/landmark{
	name = "JoinLateCryo"
	},
/turf/unsimulated/floor/grass,
/area/centcom)
"qMW" = (
/obj/item/gun/projectile/pistol/m19,
/turf/simulated/floor/exoplanet/concrete/reinforced/road,
/area/centcom)
"qRd" = (
/obj/item/clothing/suit/space/void/security,
/turf/simulated/floor/exoplanet/concrete/reinforced/road,
/area/centcom)
"reO" = (
/obj/item/gun/projectile/pistol/magnum_pistol,
/turf/simulated/floor/exoplanet/concrete/reinforced/road,
/area/centcom)
"rJb" = (
/obj/item/gun/projectile/automatic/sec_smg,
/turf/simulated/floor/exoplanet/concrete/reinforced/road,
/area/centcom)
"sao" = (
/obj/item/gun/projectile/sniper/semistrip,
/turf/simulated/floor/exoplanet/concrete/reinforced/road,
/area/centcom)
"sJt" = (
/obj/structure/table/steel,
/turf/simulated/floor/exoplanet/concrete/reinforced/road,
/area/centcom)
"uzJ" = (
/turf/unsimulated/wall,
/area/centcom)
"uVd" = (
/obj/item/clothing/suit/space/void/atmos,
/turf/simulated/floor/exoplanet/concrete/reinforced/road,
/area/centcom)
"vLC" = (
/obj/item/gun/projectile/automatic/merc_smg,
/turf/simulated/floor/exoplanet/concrete/reinforced/road,
/area/centcom)
"vPX" = (
/obj/item/gun/energy/mindflayer,
/turf/simulated/floor/exoplanet/concrete/reinforced/road,
/area/centcom)
"wVg" = (
/obj/item/gun/energy/laser,
/turf/simulated/floor/exoplanet/concrete/reinforced/road,
/area/centcom)
"xbv" = (
/obj/item/clothing/suit/space/void/merc,
/turf/simulated/floor/exoplanet/concrete/reinforced/road,
/area/centcom)
"xBf" = (
/obj/item/gun/energy/lasercannon,
/turf/simulated/floor/exoplanet/concrete/reinforced/road,
/area/centcom)

(1,1,1) = {"
jjy
jjy
jjy
jjy
jjy
uzJ
uzJ
uzJ
uzJ
uzJ
uzJ
uzJ
uzJ
uzJ
jjy
jjy
jjy
jjy
jjy
jjy
jjy
jjy
jjy
jjy
"}
(2,1,1) = {"
uzJ
uzJ
uzJ
uzJ
uzJ
uzJ
cpC
cpC
cpC
cpC
cpC
cpC
cpC
uzJ
jjy
jjy
jjy
jjy
jjy
jjy
jjy
jjy
jjy
jjy
"}
(3,1,1) = {"
uzJ
cpC
cpC
cpC
cpC
cpC
cpC
pxw
pxw
pxw
uVd
cpC
cpC
uzJ
jjy
jjy
jjy
jjy
jjy
jjy
jjy
jjy
jjy
jjy
"}
(4,1,1) = {"
uzJ
cpC
dRf
cpC
cpC
cpC
cpC
pxw
pxw
pxw
xbv
cpC
cpC
uzJ
jjy
jjy
uzJ
uzJ
uzJ
uzJ
uzJ
jjy
jjy
jjy
"}
(5,1,1) = {"
uzJ
cpC
dRf
dRf
cpC
cpC
cpC
pxw
pxw
pxw
qRd
cpC
cpC
uzJ
uzJ
uzJ
uzJ
cpC
cpC
cpC
uzJ
uzJ
uzJ
jjy
"}
(6,1,1) = {"
uzJ
cpC
dRf
cpC
cpC
cpC
cpC
odH
odH
odH
cpC
cpC
cpC
uzJ
uzJ
cpC
cpC
cpC
cpC
cpC
cpC
cpC
uzJ
jjy
"}
(7,1,1) = {"
uzJ
cpC
dRf
dRf
cpC
cpC
cpC
odH
odH
odH
cpC
cpC
cpC
uzJ
uzJ
cpC
cpC
ooX
ooX
ooX
cpC
cpC
uzJ
uzJ
"}
(8,1,1) = {"
uzJ
cpC
dRf
dRf
cpC
cpC
cpC
odH
odH
odH
cpC
cpC
cpC
cpC
cpC
cpC
ooX
ooX
ooX
ooX
ooX
cpC
cpC
uzJ
"}
(9,1,1) = {"
uzJ
cpC
cpC
cpC
cpC
cpC
cpC
pnX
pnX
dre
cpC
cpC
cpC
cpC
cpC
cpC
ooX
ooX
pSk
ooX
ooX
cpC
cpC
uzJ
"}
(10,1,1) = {"
uzJ
uzJ
uzJ
uzJ
uzJ
uzJ
cpC
pnX
pnX
pnX
cpC
cpC
cpC
cpC
cpC
cpC
ooX
ooX
ooX
ooX
ooX
cpC
cpC
uzJ
"}
(11,1,1) = {"
jjy
jjy
jjy
jjy
jjy
uzJ
cpC
pnX
pnX
pnX
cpC
cpC
cpC
uzJ
uzJ
cpC
cpC
ooX
ooX
ooX
cpC
cpC
uzJ
uzJ
"}
(12,1,1) = {"
jjy
jjy
jjy
jjy
jjy
uzJ
cpC
cpC
cpC
cpC
cpC
cpC
cpC
uzJ
uzJ
cpC
cpC
cpC
cpC
cpC
cpC
cpC
uzJ
jjy
"}
(13,1,1) = {"
jjy
jjy
jjy
jjy
jjy
uzJ
uzJ
uzJ
uzJ
uzJ
uzJ
uzJ
uzJ
uzJ
uzJ
uzJ
uzJ
cpC
cpC
cpC
uzJ
uzJ
uzJ
uzJ
"}
(14,1,1) = {"
jjy
jjy
jjy
jjy
jjy
jjy
jjy
jjy
uzJ
cpC
cpC
cpC
cpC
cpC
cpC
mJI
sJt
cpC
fkK
vPX
xBf
lUp
wVg
uzJ
"}
(15,1,1) = {"
jjy
jjy
jjy
jjy
jjy
jjy
jjy
jjy
uzJ
cpC
cpC
cpC
cpC
cpC
cpC
cpC
uzJ
cpC
cpC
cpC
cpC
cpC
cpC
uzJ
"}
(16,1,1) = {"
jjy
jjy
jjy
jjy
jjy
jjy
jjy
jjy
uzJ
cpC
cpC
cpC
cpC
cpC
mJI
cpC
sJt
cpC
nuF
ldi
nsq
cPZ
geK
uzJ
"}
(17,1,1) = {"
jjy
jjy
jjy
jjy
jjy
jjy
jjy
jjy
uzJ
cpC
cpC
cpC
cpC
mJI
cpC
cpC
sJt
cpC
cpC
cpC
cpC
cpC
cpC
uzJ
"}
(18,1,1) = {"
jjy
jjy
jjy
jjy
jjy
jjy
jjy
jjy
uzJ
cpC
cpC
cpC
cpC
cpC
cpC
cpC
uzJ
cpC
rJb
jDb
eZS
vLC
nyu
uzJ
"}
(19,1,1) = {"
jjy
jjy
jjy
jjy
jjy
jjy
jjy
jjy
uzJ
cpC
cpC
cpC
mJI
cpC
cpC
cpC
sJt
cpC
cpC
cpC
cpC
cpC
cpC
uzJ
"}
(20,1,1) = {"
jjy
jjy
jjy
jjy
jjy
jjy
jjy
jjy
uzJ
cpC
cpC
mJI
cpC
cpC
cpC
cpC
sJt
cpC
eDA
sao
qMW
reO
kSl
uzJ
"}
(21,1,1) = {"
jjy
jjy
jjy
jjy
jjy
jjy
jjy
jjy
uzJ
cpC
cpC
cpC
cpC
cpC
cpC
cpC
uzJ
cpC
cpC
cpC
cpC
cpC
cpC
uzJ
"}
(22,1,1) = {"
jjy
jjy
jjy
jjy
jjy
jjy
jjy
jjy
uzJ
cpC
mJI
cpC
cpC
cpC
cpC
cpC
sJt
cpC
cpC
cpC
cpC
cpC
cpC
uzJ
"}
(23,1,1) = {"
jjy
jjy
jjy
jjy
jjy
jjy
jjy
jjy
uzJ
mJI
cpC
cpC
cpC
cpC
cpC
cpC
sJt
cpC
cpC
cpC
cpC
cpC
cpC
uzJ
"}
(24,1,1) = {"
jjy
jjy
jjy
jjy
jjy
jjy
jjy
jjy
uzJ
cpC
cpC
cpC
cpC
cpC
cpC
cpC
uzJ
cpC
cpC
cpC
cpC
cpC
cpC
uzJ
"}
(25,1,1) = {"
jjy
jjy
jjy
jjy
jjy
jjy
jjy
jjy
uzJ
cpC
cpC
cpC
cpC
cpC
cpC
cpC
cpC
cpC
cpC
cpC
cpC
cpC
cpC
uzJ
"}
(26,1,1) = {"
jjy
jjy
jjy
jjy
jjy
jjy
jjy
jjy
uzJ
uzJ
uzJ
uzJ
uzJ
uzJ
uzJ
uzJ
uzJ
cpC
cpC
cpC
uzJ
uzJ
uzJ
uzJ
"}
(27,1,1) = {"
jjy
jjy
jjy
jjy
jjy
jjy
jjy
jjy
jjy
jjy
jjy
jjy
jjy
jjy
jjy
jjy
uzJ
uzJ
uzJ
uzJ
uzJ
jjy
jjy
jjy
"}
