"a" = (/obj/landmark/clear,/turf/simulated/floor/exoplanet/grass,/area/template_noop)
"m" = (/obj/structure/flora/ausbushes/brflowers,/obj/landmark/clear,/turf/simulated/floor/exoplanet/grass,/area/template_noop)
"A" = (/obj/fairy_ring_portal,/obj/landmark/clear,/turf/simulated/floor/exoplanet/grass,/area/template_noop)
"C" = (/obj/structure/flora/ausbushes/ppflowers,/obj/landmark/clear,/turf/simulated/floor/exoplanet/grass,/area/template_noop)
"X" = (/obj/structure/flora/ausbushes/ywflowers,/obj/landmark/clear,/turf/simulated/floor/exoplanet/grass,/area/template_noop)
"Z" = (/turf/template_noop,/area/template_noop)

(1,1,1) = {"
ZZaaZZZZZZZ
ZaaaaZZZZZZ
aaaaaaaZaaZ
ZaaamCCaaaa
ZaaCaaaXaaa
aaamaAaXaaa
aaaXaaamaaZ
ZaaaCXCaaaZ
ZZaaaaaaaaZ
ZaaaaaZaaZZ
ZZaaaZZZaZZ
"}
