"u" = (/turf/template_noop,/area/template_noop)
"y" = (/obj/landmark/map_load_mark/field_of_suits,/turf/template_noop,/area/template_noop)

(1,1,1) = {"
uuuuuuuuuuuuu
uuuuuuuuuuuuu
uuuuuuuuuuuuu
uuuuuuuuuuuuu
uuuuuuyuuuuuu
uuuuuuuuuuuuu
uuuuuuuuuuuuu
uuuuuuuuuuuuu
uuuuuuuuuuuuu
uuuuuuuuuuuuu
"}
