"a" = (/obj/item/device/gps,/obj/landmark/clear,/turf/simulated/floor/exoplanet/barren,/area/template_noop)
"e" = (/obj/random/firstaid,/obj/landmark/clear,/turf/template_noop,/area/template_noop)
"g" = (/obj/structure/flora/ausbushes/sparsegrass,/obj/landmark/clear,/turf/simulated/floor/exoplanet/barren,/area/template_noop)
"h" = (/obj/machinery/suspension_gen{dir = 4},/obj/landmark/clear,/turf/simulated/floor/exoplanet/barren,/area/template_noop)
"j" = (/obj/random/powercell,/obj/landmark/clear,/turf/simulated/floor/exoplanet/barren,/area/template_noop)
"k" = (/obj/structure/flora/ausbushes/brflowers,/obj/landmark/clear,/turf/simulated/floor/exoplanet/barren,/area/template_noop)
"m" = (/obj/random/toolbox,/obj/landmark/clear,/turf/simulated/floor/exoplanet/barren,/area/template_noop)
"q" = (/obj/random/loot,/obj/random/loot,/obj/landmark/clear,/turf/simulated/floor/exoplanet/barren,/area/template_noop)
"s" = (/turf/template_noop,/area/template_noop)
"t" = (/obj/machinery/anomaly_container,/obj/landmark/clear,/turf/simulated/floor/exoplanet/barren,/area/template_noop)
"x" = (/obj/landmark/clear,/turf/template_noop,/area/template_noop)
"A" = (/obj/item/device/ano_scanner,/obj/landmark/clear,/turf/simulated/floor/exoplanet/barren,/area/template_noop)
"C" = (/obj/random/powercell,/obj/random/powercell,/obj/landmark/clear,/turf/simulated/floor/exoplanet/barren,/area/template_noop)
"D" = (/obj/random/tool,/obj/landmark/clear,/turf/simulated/floor/exoplanet/barren,/area/template_noop)
"E" = (/obj/structure/flora/ausbushes/lavendergrass,/obj/landmark/clear,/turf/simulated/floor/exoplanet/barren,/area/template_noop)
"F" = (/obj/random/human_statue{dir = 8},/obj/landmark/clear,/turf/simulated/floor/exoplanet/barren,/area/template_noop)
"G" = (/obj/random/loot,/obj/random/trash,/obj/landmark/clear,/turf/simulated/floor/exoplanet/barren,/area/template_noop)
"K" = (/obj/machinery/floodlight{dir = 4},/obj/landmark/clear,/turf/template_noop,/area/template_noop)
"N" = (/obj/random/tool,/obj/random/medical/lite,/obj/landmark/clear,/turf/simulated/floor/exoplanet/barren,/area/template_noop)
"O" = (/obj/landmark/clear,/turf/simulated/floor/exoplanet/barren,/area/template_noop)
"P" = (/obj/random/trash,/obj/landmark/clear,/turf/template_noop,/area/template_noop)
"Q" = (/obj/random/trash,/obj/landmark/clear,/turf/simulated/floor/exoplanet/barren,/area/template_noop)
"R" = (/obj/item/pickaxe/xeno/hand,/obj/landmark/clear,/turf/simulated/floor/exoplanet/barren,/area/template_noop)
"S" = (/obj/structure/pit,/obj/landmark/clear,/turf/simulated/floor/exoplanet/barren,/area/template_noop)
"U" = (/obj/random/human_statue{dir = 4},/obj/landmark/clear,/turf/template_noop,/area/template_noop)
"V" = (/obj/random/human_statue,/obj/landmark/clear,/turf/simulated/floor/exoplanet/barren,/area/template_noop)
"X" = (/obj/machinery/floodlight,/obj/landmark/clear,/turf/template_noop,/area/template_noop)
"Z" = (/obj/item/archaeological_find/fossil,/obj/item/archaeological_find/fossil,/obj/item/archaeological_find/fossil,/obj/item/archaeological_find/fossil,/obj/structure/closet/crate,/obj/landmark/clear,/turf/template_noop,/area/template_noop)

(1,1,1) = {"
ssxXEqs
xZxDmCO
POGVaQk
OEhSFQt
KRjQONx
sUxAges
"}
