//MAP CONVERTED BY dmm2tgm.py THIS HEADER COMMENT PREVENTS RECONVERSION, DO NOT REMOVE
"aO" = (
/obj/structure/bookcase,
/turf/simulated/floor/wood{
	icon_state = "wood_broken5"
	},
/area/map_template/anomaly/flying_home)
"aY" = (
/obj/structure/table/woodentable_reinforced{
	pixel_x = 12
	},
/obj/decal/cleanable/dirt,
/turf/simulated/floor/wood,
/area/map_template/anomaly/flying_home)
"ba" = (
/obj/structure/flora/ausbushes/fullgrass,
/obj/flying_planet_deco/tree,
/turf/simulated/floor/exoplanet/grass,
/area/map_template/anomaly/flying_home)
"cH" = (
/obj/structure/flora/ausbushes/sparsegrass,
/obj/decal/cleanable/dirt,
/turf/simulated/floor/wood{
	icon_state = "wood_broken0"
	},
/area/map_template/anomaly/flying_home)
"em" = (
/obj/decal/cleanable/dirt,
/turf/simulated/floor/wood{
	icon_state = "wood_broken0"
	},
/area/map_template/anomaly/flying_home)
"eF" = (
/obj/item/stack/material/wood,
/obj/decal/cleanable/dirt,
/turf/simulated/floor/wood,
/area/map_template/anomaly/flying_home)
"eQ" = (
/obj/anomaly/rvach/three_and_three,
/turf/simulated/floor/wood,
/area/template_noop)
"fq" = (
/obj/structure/rubble/house,
/obj/decal/cleanable/dirt,
/turf/simulated/floor/wood,
/area/map_template/anomaly/flying_home)
"fM" = (
/obj/structure/flora/ausbushes/grassybush,
/obj/item/stack/material/wood,
/obj/decal/cleanable/dirt,
/turf/simulated/floor/wood{
	icon_state = "wood_broken4"
	},
/area/map_template/anomaly/flying_home)
"gq" = (
/obj/structure/table/woodentable_reinforced,
/obj/decal/cleanable/dirt,
/turf/simulated/floor/wood{
	icon_state = "wood_broken0"
	},
/area/map_template/anomaly/flying_home)
"gM" = (
/obj/structure/bookcase,
/turf/simulated/floor/wood,
/area/map_template/anomaly/flying_home)
"iO" = (
/obj/structure/flora/ausbushes/sparsegrass,
/obj/decal/cleanable/dirt,
/turf/simulated/floor/wood{
	icon_state = "wood_broken5"
	},
/area/map_template/anomaly/flying_home)
"jO" = (
/obj/structure/coatrack,
/obj/decal/cleanable/dirt,
/turf/simulated/floor/wood,
/area/map_template/anomaly/flying_home)
"jU" = (
/obj/structure/flora/ausbushes/fullgrass,
/obj/item/stack/material/wood,
/obj/flying_planet_deco/tree,
/turf/simulated/floor/exoplanet/grass,
/area/map_template/anomaly/flying_home)
"ke" = (
/obj/structure/table/woodentable_reinforced,
/obj/item/pen,
/obj/decal/cleanable/dirt,
/turf/simulated/floor/wood,
/area/map_template/anomaly/flying_home)
"lh" = (
/obj/structure/table/woodentable_reinforced,
/obj/item/reagent_containers/food/drinks/dry_ramen{
	pixel_y = -6
	},
/obj/item/reagent_containers/food/drinks/dry_ramen{
	pixel_y = 9;
	pixel_x = 5
	},
/obj/item/reagent_containers/food/drinks/dry_ramen{
	pixel_y = 6;
	pixel_x = -6
	},
/turf/simulated/floor/wood,
/area/map_template/anomaly/flying_home)
"lm" = (
/obj/structure/reagent_dispensers/water_cooler,
/obj/decal/cleanable/dirt,
/turf/simulated/floor/wood,
/area/map_template/anomaly/flying_home)
"ob" = (
/obj/structure/flora/ausbushes/fullgrass,
/obj/decal/cleanable/dirt,
/turf/simulated/floor/wood{
	icon_state = "wood_broken0"
	},
/area/map_template/anomaly/flying_home)
"oh" = (
/obj/structure/flora/bush,
/turf/simulated/floor/exoplanet/grass,
/area/map_template/anomaly/flying_home)
"oX" = (
/obj/item/stack/material/wood,
/turf/simulated/floor/wood{
	icon_state = "wood_broken0"
	},
/area/template_noop)
"qW" = (
/obj/structure/flora/bush,
/obj/flying_planet_deco/tree,
/turf/simulated/floor/exoplanet/grass,
/area/map_template/anomaly/flying_home)
"rR" = (
/obj/item/stack/material/wood,
/obj/structure/flora/ausbushes/fullgrass,
/obj/decal/cleanable/dirt,
/turf/simulated/floor/wood{
	icon_state = "wood_broken4"
	},
/area/map_template/anomaly/flying_home)
"st" = (
/obj/structure/coatrack,
/obj/decal/cleanable/dirt,
/turf/simulated/floor/wood{
	icon_state = "wood_broken2"
	},
/area/map_template/anomaly/flying_home)
"tQ" = (
/obj/decal/cleanable/dirt,
/turf/simulated/floor/wood,
/area/map_template/anomaly/flying_home)
"uf" = (
/obj/structure/flora/ausbushes/genericbush,
/obj/decal/cleanable/dirt,
/turf/simulated/floor/wood{
	icon_state = "wood_broken4"
	},
/area/map_template/anomaly/flying_home)
"uu" = (
/obj/structure/flora/ausbushes/sparsegrass,
/obj/decal/cleanable/dirt,
/turf/simulated/floor/wood{
	icon_state = "wood_broken4"
	},
/area/map_template/anomaly/flying_home)
"uG" = (
/obj/item/stack/material/wood,
/obj/flying_planet_deco/tree,
/turf/simulated/floor/exoplanet/grass,
/area/map_template/anomaly/flying_home)
"uX" = (
/obj/item/stack/material/wood,
/obj/decal/cleanable/dirt,
/turf/simulated/floor/wood{
	icon_state = "wood_broken3"
	},
/area/map_template/anomaly/flying_home)
"vs" = (
/turf/template_noop,
/area/template_noop)
"vy" = (
/obj/structure/flora/ausbushes/sparsegrass,
/obj/flying_planet_deco/tree,
/turf/simulated/floor/exoplanet/grass,
/area/map_template/anomaly/flying_home)
"vK" = (
/obj/item/stack/material/wood,
/obj/structure/flora/ausbushes/fullgrass,
/obj/decal/cleanable/dirt,
/turf/simulated/floor/wood{
	icon_state = "wood_broken0"
	},
/area/map_template/anomaly/flying_home)
"wx" = (
/obj/decal/cleanable/dirt,
/turf/simulated/floor/wood{
	icon_state = "wood_broken5"
	},
/area/map_template/anomaly/flying_home)
"wB" = (
/obj/structure/flora/ausbushes/grassybush,
/obj/decal/cleanable/dirt,
/turf/simulated/floor/wood{
	icon_state = "wood_broken0"
	},
/area/map_template/anomaly/flying_home)
"wJ" = (
/obj/decal/cleanable/dirt,
/turf/simulated/floor/wood{
	icon_state = "wood_broken3"
	},
/area/map_template/anomaly/flying_home)
"xb" = (
/obj/structure/table/woodentable_reinforced,
/obj/item/material/knife/kitchen,
/obj/decal/cleanable/dirt,
/turf/simulated/floor/wood,
/area/map_template/anomaly/flying_home)
"xf" = (
/obj/structure/flora/ausbushes/palebush,
/turf/simulated/floor/exoplanet/grass,
/area/map_template/anomaly/flying_home)
"xo" = (
/obj/flying_planet_deco/tree,
/turf/simulated/floor/exoplanet/grass,
/area/template_noop)
"xy" = (
/obj/structure/flora/ausbushes/sparsegrass,
/obj/decal/cleanable/dirt,
/turf/simulated/floor/wood{
	icon_state = "wood_broken3"
	},
/area/map_template/anomaly/flying_home)
"yQ" = (
/obj/structure/flora/ausbushes/sparsegrass,
/obj/item/stack/material/wood,
/turf/simulated/floor/exoplanet/grass,
/area/map_template/anomaly/flying_home)
"zw" = (
/turf/simulated/floor/exoplanet/grass,
/area/map_template/anomaly/flying_home)
"Az" = (
/obj/structure/table/woodentable_reinforced,
/obj/item/toy/plushie/kitten,
/turf/simulated/floor/wood,
/area/map_template/anomaly/flying_home)
"AA" = (
/obj/item/stack/material/wood,
/obj/decal/cleanable/dirt,
/turf/simulated/floor/wood{
	icon_state = "wood_broken0"
	},
/area/map_template/anomaly/flying_home)
"AB" = (
/obj/item/stack/material/wood,
/obj/structure/flora/ausbushes/fullgrass,
/obj/decal/cleanable/dirt,
/turf/simulated/floor/wood{
	icon_state = "wood_broken3"
	},
/area/map_template/anomaly/flying_home)
"CS" = (
/obj/structure/flora/ausbushes/stalkybush,
/turf/simulated/floor/exoplanet/grass,
/area/map_template/anomaly/flying_home)
"DQ" = (
/obj/item/stack/material/wood,
/obj/decal/cleanable/dirt,
/turf/simulated/floor/wood{
	icon_state = "wood_broken5"
	},
/area/map_template/anomaly/flying_home)
"Em" = (
/obj/structure/bed/chair/armchair/brown,
/obj/decal/cleanable/dirt,
/turf/simulated/floor/wood,
/area/map_template/anomaly/flying_home)
"Ep" = (
/obj/structure/table/steel_reinforced,
/obj/item/storage/toolbox/electrical,
/obj/decal/cleanable/dirt,
/turf/simulated/floor/wood,
/area/map_template/anomaly/flying_home)
"EU" = (
/obj/flying_planet_deco/tree,
/turf/simulated/floor/exoplanet/grass,
/area/map_template/anomaly/flying_home)
"Fj" = (
/turf/simulated/floor/wood,
/area/template_noop)
"Gt" = (
/obj/structure/flora/ausbushes/fullgrass,
/turf/simulated/floor/exoplanet/grass,
/area/map_template/anomaly/flying_home)
"GM" = (
/obj/item/stack/material/wood,
/turf/simulated/floor/exoplanet/grass,
/area/map_template/anomaly/flying_home)
"Ii" = (
/obj/structure/flora/ausbushes/leafybush,
/obj/decal/cleanable/dirt,
/turf/simulated/floor/wood{
	icon_state = "wood_broken3"
	},
/area/map_template/anomaly/flying_home)
"Iv" = (
/obj/item/material/shard/shrapnel/steel,
/turf/simulated/floor/wood{
	icon_state = "wood_broken3"
	},
/area/template_noop)
"IW" = (
/obj/structure/flora/ausbushes/leafybush,
/obj/decal/cleanable/dirt,
/turf/simulated/floor/wood{
	icon_state = "wood_broken4"
	},
/area/map_template/anomaly/flying_home)
"Kv" = (
/obj/structure/table/woodentable_reinforced{
	pixel_x = 12
	},
/obj/item/forensics/sample_kit,
/obj/decal/cleanable/dirt,
/turf/simulated/floor/wood{
	icon_state = "wood_broken4"
	},
/area/map_template/anomaly/flying_home)
"Mu" = (
/turf/simulated/wall/wood,
/area/map_template/anomaly/flying_home)
"PA" = (
/obj/structure/table/woodentable_reinforced,
/obj/item/paper_bin,
/obj/decal/cleanable/dirt,
/turf/simulated/floor/wood,
/area/map_template/anomaly/flying_home)
"RL" = (
/obj/structure/flora/ausbushes/grassybush,
/turf/simulated/floor/exoplanet/grass,
/area/map_template/anomaly/flying_home)
"Tj" = (
/obj/structure/flora/ausbushes/ywflowers,
/turf/simulated/floor/exoplanet/grass,
/area/map_template/anomaly/flying_home)
"TM" = (
/obj/structure/flora/ausbushes/fullgrass,
/turf/simulated/floor/exoplanet/grass,
/area/template_noop)
"TT" = (
/obj/structure/bed/padded,
/obj/item/bedsheet/orange,
/obj/structure/curtain/open/bed{
	anchored = 1
	},
/turf/simulated/floor/wood,
/area/map_template/anomaly/flying_home)
"Ua" = (
/turf/simulated/floor/wood{
	icon_state = "wood_broken3"
	},
/area/template_noop)
"Uy" = (
/obj/anomaly/rvach/three_and_three,
/turf/simulated/floor/wood{
	icon_state = "wood_broken3"
	},
/area/template_noop)
"UE" = (
/obj/structure/flora/ausbushes/grassybush,
/obj/decal/cleanable/dirt,
/turf/simulated/floor/wood{
	icon_state = "wood_broken2"
	},
/area/map_template/anomaly/flying_home)
"Vg" = (
/obj/structure/table/woodentable_reinforced,
/obj/item/forensics/sample_kit/powder,
/obj/decal/cleanable/dirt,
/turf/simulated/floor/wood,
/area/map_template/anomaly/flying_home)
"Vq" = (
/obj/structure/flora/ausbushes/fullgrass,
/obj/decal/cleanable/dirt,
/turf/simulated/floor/wood{
	icon_state = "wood_broken2"
	},
/area/map_template/anomaly/flying_home)
"We" = (
/obj/structure/flora/ausbushes/grassybush,
/obj/decal/cleanable/dirt,
/turf/simulated/floor/wood{
	icon_state = "wood_broken5"
	},
/area/map_template/anomaly/flying_home)
"Wz" = (
/obj/structure/table/steel_reinforced,
/obj/decal/cleanable/dirt,
/turf/simulated/floor/wood,
/area/map_template/anomaly/flying_home)
"WN" = (
/obj/item/stack/material/wood,
/turf/simulated/floor/wood{
	icon_state = "wood_broken4"
	},
/area/template_noop)
"WZ" = (
/obj/structure/closet/walllocker{
	pixel_x = -28
	},
/obj/item/storage/firstaid/stab{
	pixel_y = -10
	},
/obj/decal/cleanable/dirt,
/turf/simulated/floor/wood,
/area/map_template/anomaly/flying_home)
"Xd" = (
/obj/item/stack/material/wood,
/turf/simulated/floor/wood{
	icon_state = "wood_broken3"
	},
/area/template_noop)
"Xs" = (
/obj/structure/flora/ausbushes/fullgrass,
/obj/item/stack/material/wood,
/obj/decal/cleanable/dirt,
/turf/simulated/floor/wood{
	icon_state = "wood_broken4"
	},
/area/map_template/anomaly/flying_home)
"YF" = (
/obj/structure/flora/ausbushes/sparsegrass,
/turf/simulated/floor/exoplanet/grass,
/area/map_template/anomaly/flying_home)
"Zj" = (
/obj/structure/table/woodentable_reinforced,
/obj/decal/cleanable/dirt,
/turf/simulated/floor/wood,
/area/map_template/anomaly/flying_home)
"Zz" = (
/turf/simulated/floor/exoplanet/grass,
/area/template_noop)

(1,1,1) = {"
vs
vs
vs
vs
EU
xf
vs
zw
vs
vs
vs
vs
vs
vs
vs
vs
"}
(2,1,1) = {"
vs
vs
RL
zw
zw
zw
zw
EU
GM
zw
vy
vs
vs
vs
vs
vs
"}
(3,1,1) = {"
vs
qW
GM
Mu
Mu
Mu
Mu
Mu
Mu
Mu
Mu
GM
Gt
zw
vs
vs
"}
(4,1,1) = {"
oh
oh
YF
Mu
eF
Vq
wB
lh
fM
gM
Mu
Gt
EU
Gt
EU
vs
"}
(5,1,1) = {"
vs
GM
EU
Mu
Em
wx
eF
Az
em
aO
Mu
zw
xy
zw
GM
vs
"}
(6,1,1) = {"
vs
zw
Tj
Mu
vK
fq
cH
Zj
yQ
gM
Mu
Mu
fq
Mu
Mu
zw
"}
(7,1,1) = {"
vs
zw
AB
ob
tQ
uf
tQ
eF
tQ
tQ
IW
WZ
uX
tQ
Mu
ba
"}
(8,1,1) = {"
GM
CS
zw
Mu
eF
rR
fq
tQ
rR
iO
Mu
Wz
Ep
Iv
oX
Zz
"}
(9,1,1) = {"
zw
YF
zw
Mu
jO
uX
Zj
xb
Zj
tQ
Mu
Mu
Mu
WN
eQ
Zz
"}
(10,1,1) = {"
vs
GM
zw
Mu
st
We
Vg
AA
UE
DQ
Mu
zw
Gt
Zz
TM
Zz
"}
(11,1,1) = {"
vs
EU
zw
Mu
lm
wJ
gq
aY
Kv
aY
Mu
YF
GM
ba
zw
vs
"}
(12,1,1) = {"
vs
YF
oh
Mu
Mu
ob
Mu
Mu
Mu
Mu
Mu
EU
zw
vs
vs
vs
"}
(13,1,1) = {"
vs
uG
Zz
Xd
Fj
tQ
Xs
ke
PA
Zj
Mu
YF
zw
vs
vs
vs
"}
(14,1,1) = {"
vs
vs
xo
Uy
Fj
tQ
eF
eF
wx
Zj
Mu
zw
zw
zw
vs
vs
"}
(15,1,1) = {"
vs
vs
Zz
Xd
Fj
Ua
Xd
Fj
tQ
Ii
Mu
yQ
zw
vy
vs
vs
"}
(16,1,1) = {"
vs
vs
vy
Mu
tQ
Xd
Uy
Xd
uu
TT
Mu
zw
YF
zw
EU
vs
"}
(17,1,1) = {"
vs
zw
zw
Mu
Mu
Xd
Ua
Xd
Mu
Mu
Mu
YF
zw
vs
vs
vs
"}
(18,1,1) = {"
vy
GM
vy
zw
vy
GM
zw
jU
zw
EU
YF
EU
YF
vs
vs
vs
"}
(19,1,1) = {"
vs
YF
zw
GM
YF
vs
vs
vs
vs
vs
vs
vs
vs
vs
vs
vs
"}
(20,1,1) = {"
vs
vs
YF
EU
vs
vs
vs
vs
vs
vs
vs
vs
vs
vs
vs
vs
"}
